Suna hai #Notebandi se atankiyo ki #Nasbandi karni thi Kaka Contraceptive lekar gae the par Viagra gift kar ke aa gae #NoteBandi	Other Other Other Other Other Other Other Other Other Other Other Other Other Other Other Other Other Other Other Other Other Other
@ArvindKejriwal Modi Ji k 3 maar me pehli maar #Notebandi to aap ko barbad kiya Lekin sab Vyaapari 3 maar se khush hai Iss liye to Log BJP ko har chunav me Jita rahe	B-Per B-Per I-Per Other Other Other Other Other Other Other Other Other Other Other Other Other Other Other Other Other Other Other Other Other Other Other Other B-Org Other Other Other Other Other Other
Economy ka beda gark sirf @arunjaitley ne nhi kiya 0 sbko pata h #Notebandi kisne kiya tha 0 #GST KO LAGU KARNE K DAURAN KOI BADLAV NAHI HUA #NOTEBANDI KI TARAH	Other Other Other Other Other B-Org Other Other Other Other Other Other Other Other Other Other Other Other Other Other Other Other Other Other Other Other Other Other Other Other Other
abhi baki hai mere dost ..	Other Other Other Other Other Other
This #Diwali celebrate with #Notebandi phus phus Anar & #GST kaala saanp	Other Other Other Other Other Other Other Other Other Other Other Other
#SurgicalStrick k sbut nh dye to Army se bhrosa uth gya #NoteBandi kye to Gvt 0 Se .. #Election hare to EVM se .. Aise log Duniya se q nh uth jate	Other Other Other Other Other Other B-Org Other Other Other Other Other Other Other Other Other Other Other Other Other Other Other Other Other Other Other Other Other Other Other Other Other
#notebandi #ModiNo1 #ElectionResults #ResultsWithNDTV	Other Other Other Other
@Pappu @Maya @Kejri ko #Notebandi ki pareshani NAHI Hoti 0 Kaise ? Fake currency , curroption ka ilaj ek teeke se hota #AgarModiJiDoctorHote	B-Per B-Per B-Per Other Other Other Other Other Other Other Other Other Other Other Other Other Other Other Other Other Other Other Other
Dekhiye Feku ne to economy ko barbaad kiya #NoteBandi ke naam pe 0 15m jobs khatm huey par unka chowraha wala wada to dhare ke dhare rah gaye	Other Other Other Other Other Other Other Other Other Other Other Other Other Other Other Other Other Other Other Other Other Other Other Other Other Other Other Other
sir agar mai #LOGON me aata hu to mai yahi kahunga ki ..... i support #Notebandi bcoz chor log to zinda mar hi gayae .... or 125 crore ke population ke liyae aisa koi rule nahi ho sakta jisme sab lo khush rahe ... kisi ko to dikkt hogi hi..bt aapko kyun hui ???	Other Other Other Other Other Other Other Other Other Other Other Other Other Other Other Other Other Other Other Other Other Other Other Other Other Other Other Other Other Other Other Other Other Other Other Other Other Other Other Other Other Other Other Other Other Other Other Other Other Other Other Other Other Other
Shah-Zade ne 50 Rupees ki company shuru ki , foreign se invoice pe payments liye , 81 Crore turn over kiya , #Notebandi se pehle company close kardi , iss mein kya galat kiya ?	Other Other Other Other Other Other Other Other Other Other Other Other Other Other Other Other Other Other Other Other Other Other Other Other Other Other Other Other Other Other Other Other Other Other Other
Garib kal bhi Carib the , aj bhi garib hai .. #notebandi sirf corruption k khilaf thi , jo bhut hadd tak control me aa gayi hai ..	Other Other Other Other Other Other Other Other Other Other Other Other Other Other Other Other Other Other Other Other Other Other Other Other Other Other Other Other
Kya #NoteBandi k jashn me unn logon k pariwar valo ko bulaya jaega jinke relatives ki #Banks ki line me lag k death hui ?	Other Other Other Other Other Other Other Other Other Other Other Other Other Other Other Other B-Org Other Other Other Other Other Other Other Other
Where is the team of #TripleTalaq? #Modi ji Behne yaad hai ? Sack this culprit @PremShuklaBJP ya Aurto par diya hua bhaashan bhi Jumla hi tha	Other Other Other Other Other Other B-Per I-Per Other Other Other Other Other Other Other B-Per Other Other Other Other Other Other Other Other Other Other
#TripleTalaq kisi ke murder se to acha hy Lekin pehle murde ko jalane pr ban lage	Other Other Other Other Other Other Other Other Other Other Other Other Other Other Other Other
rape pideeton ke sath sath thodi chinta triple talaq pideet mahilao ka bhi kariye madam?? #TripleTalaq	Other Other Other Other Other Other Other Other Other Other Other Other Other Other Other Other
#TripleTalaq Pe ban Bahot jaruri he Aaj ke zamaane me ... Galat Fayda utha rahe he Aaj kal ke log iska ...	Other Other Other Other Other Other Other Other Other Other Other Other Other Other Other Other Other Other Other Other Other Other
Just one thing : #TripleTalaq ho ya #RamMandir #congress and #KapilSibal hamesha andho k hi paksh me dalil dete h like #JNU rahul gandhi #kanahiya k sath tha	Other Other Other Other Other Other Other Other B-Org Other B-Per Other Other Other Other Other Other Other Other Other Other Other B-Per I-Per B-Per Other Other Other
Small village ka bhi news dikhao kabi #TripleTalaq Kabi #Kashmiri #Up #Yogi in se bhi bahar niklo Sir Ji @aajtak @sardesairajdeep	Other Other Other Other Other Other Other Other Other B-Loc B-Loc B-Per Other Other Other Other Other Other Other Other Other
Bhai #TripleTalaq koi issue Hi NHi h ... Aur itna aasan NHi Hota talaq dena ya Lena ...	Other Other Other Other Other Other Other Other Other Other Other Other Other Other Other Other Other Other
Arre yaar sati pratha b band ki gyi na .. kuch to galat laga hoga us time to phr #TripleTalaq kyun nahi ?? Isko hindu muslim me mat bandho	Other Other Other Other Other Other Other Other Other Other Other Other Other Other Other Other Other Other Other Other Other Other Other Other B-Org B-Org Other Other Other
Bhayio kuch bhi kr lo next time to bill pass ho hi jayega.. isliye tumlogo k pass kuch dino ka time hai jinko takat dena hai jaldi de do ..Nhi to baad me 3 saal seedhe bitar jaoge #TripleTalaqBill #TripleTalaq	Other Other Other Other Other Other Other Other Other Other Other Other Other Other Other Other Other Other Other Other Other Other Other Other Other Other Other Other Other Other Other Other Other Other Other Other Other Other Other Other
Modi ji #TripleTalaq ko Religious daayare mein dekne k liye aap kub kalma pad k Islam Qubul kare?! Rajneeti aap kar rahe ho, sudar jawo aap	B-Per I-Per Other Other Other Other Other Other Other Other Other Other Other Other Other Other Other Other Other Other Other Other Other Other Other Other
I am definitely against #TripleTalaq Ye band hona hi chahiye aur fir Jasodaben ko bhi justice milni chahiye.	Other Other Other Other Other Other Other Other Other Other Other Other B-Per Other Other Other Other Other
Woh Aaj Kahan Mar Gaye Hain Kya ye Nari Nahin Hain Ya Inke Muslim Certification Ka Intzar Ho Raha Hai #StopTrippleTalaq #TripleTalaq	Other Other Other Other Other Other Other Other Other Other Other Other Other B-Org Other Other Other Other Other Other Other Other
#TripleTalaq	Other
#TripleTalaq Amir, sharukh, Salman aap triple talaq ke against Muslim women ka sath Kyu nhee dete. Kya Ye apki duty nhee hai.	Other B-Per B-Per B-Per Other Other Other Other Other B-Org Other Other Other Other Other Other Other Other Other Other Other Other
#TripleTalaq jo isko support kar rahe hai wo 1 bar ladki jarur bane.taqi pata to chale kysa lgta hai. Shame!	Other Other Other Other Other Other Other Other Other Other Other Other Other Other Other Other Other Other Other Other
#TripleTalaq Don't post this	Other Other Other Other
kisi mulle ne jor se bolkar pad liya to ghar ujad jayega	Other Other Other Other Other Other Other Other Other Other Other Other
TT is not applied on Jashodaben !! desh ke liye maine ghar chod diya parivaar bhi ! #tripletalaq	Other Other Other Other Other B-Per Other B-Org Other Other Other Other Other Other Other Other Other Other
#TripleTalaq ko jante nahin aur us per debate bhi kerte hein. wah ! Aur muslim women se itni hamdardi bhi wah !! @awasthis yeh isi saal kyu	Other Other Other Other Other Other Other Other Other Other Other Other Other Other B-Org Other Other Other Other Other Other Other B-Per Other Other Other Other
SC ne kaha TT dharmic mudda hua, to dakhal nahi denge!! to fir Hindu festivals ke liye dohre mapdand kyon?	B-Org Other Other Other Other Other Other Other Other Other Other Other Other B-Org Other Other Other Other Other Other
Are bhai vo Trupti desai kaha gai?ladies ka haq magne vali,vo to sirf zoothi thi hindu Muslim me dange karvane ayi thi.	Other Other Other B-Per I-Per Other Other Other Other Other Other Other Other Other Other B-Org B-Org Other Other Other Other Other
Sir do din pehle bhi ek important judgement aya tha #TripleTalaq .... us pr kyu chup the, #BawanaByPoll tha isiliye. #TripleTalaq	Other Other Other Other Other Other Other Other Other Other Other Other Other Other Other Other Other Other Other Other Other
Sir, woh *3 talaak* ka matter clear ho gyaa, Ab *saat janam* wala matter bhi dekh lijiye please @narendramodi #TripleTalaq @rsprasad #TripleTalaq	Other Other Other Other Other Other Other Other Other Other Other Other Other Other Other Other Other Other B-Per Other B-Per Other
Congress ka women empowerment sirf ek dikhawa hai #TripleTalaq #TripleTalaqBillPassed	B-Org Other Other Other Other Other Other Other Other Other
Mamaji! Aapki tarah har CM aur State Govt #GST pe Central Govt ka sahyog kare yehi iss desh ki janta ki ichha hai. #SabkaSaathSabkaVikas	Other Other Other Other Other Other B-Org I-Org Other Other B-Org I-Org Other Other Other Other Other B-Org Other Other Other Other Other Other
#GST aur #Digitalpayment Apnao desh aur Vyapar Aage Badhao! #TradeGoesDigital #DigitalforGST #CAIT	Other Other Other Other B-Org Other Other Other Other Other Other Other
.@BCBHARTIA #CAIT educates traders on #GST aur #DigitalPayment Apnao desh aur Vyapar Aage Badhao! #TradeGoesDigital @PMOIndia @narendramodi	B-Per Other Other Other Other Other Other Other Other B-Org Other Other Other Other Other Other B-Per
Aaj se pehle to aapne saare time se file kiye honge jo aaj complaint kar rahe hain.! @AwardWapasi gang activated on #GST	Other Other Other Other Other Other Other Other Other Other Other Other Other Other Other Other Other Other Other Other Other Other
#Chhattisgarh #IndiaWithRahulGandhi	B-Loc Other
#GST Lagu ho jane k Karan #GujaratRSPolls me #MLA successfully nahi kharede Jasaje Nateejatan #AhmedPatel ko rokne me #Amitshah Bakaam rahe.	Other Other Other Other Other Other Other Other Other Other Other Other Other Other B-Per Other Other Other B-Per Other Other
Tarikh pe Tarikh, Tarikh pe Tarikh, Sirf Tarikh hi Milli hai Jately Sahab par GST Credit Nahi Mila...............................#GSTR-1 #GSTR1 #GST	Other Other Other Other Other Other Other Other Other Other Other B-Per I-Per Other Other Other Other Other Other Other
Modi raj me public line me lag ke khub maze kat rahi hai Free data, sasti 2 wheelar aage dekho aur kya? #bs3 #jioprime #DeMonetisation #GST	B-Per Other Other Other Other Other Other Other Other Other Other Other Other Other Other Other Other Other Other Other Other Other Other Other Other Other
Garibonka tel nikal ne ke baad, ab mantriji Sirf kehte hai petrol/ diesel to come under #GST. Wah ! #DharmendraPradhan.	Other Other Other Other Other Other Other Other Other Other Other Other Other Other Other Other Other Other Other Other
Agar #GST, #Demonetisation, aur itne virodh ke bad bhi #BJPWinsGujarat to ye bahut badi bat hai Gujrat ki janata ka bahut bahut dhanyavad	Other Other Other Other Other Other Other Other Other Other Other Other Other Other Other Other B-Loc Other Other Other Other Other Other
Aaj jaise hi #Modi jee ne #seaplane par per rakha #Gujarat ke #Farmers ka loan maaf ho gaya #GST ke maare vyapariyo ka dhandha set ho gaya #patidar ko #Reservation mil gaya aaj poore #Gujaratpolls ka #Vikas ho gaya Source #Indian #Media	Other Other Other B-Per I-Per Other Other Other Other Other B-Loc Other Other Other Other Other Other Other Other Other Other Other Other Other Other Other Other Other Other Other Other Other Other Other Other Other Other Other Other Other B-Loc Other
desh ko #GST #demonetization se Barbad karneke baad Bhi JIN logo ne kabhi maafi nahi maangi Aise logo se hum koi Aur UMMID bhi kaise rakh sakte hai? I mean kaise? How?	B-Org Other Other Other Other Other Other Other Other Other Other Other Other Other Other Other Other Other Other Other Other Other Other Other Other Other Other Other Other Other Other Other
Jetali ji ke	B-Per I-Per Other
baithe mahashay ko #GST pr #LokSabha me discussion achchha nahi laga So rahe hain 0 #Jago .@abpnewshindi	Other Other Other Other Other Other Other Other Other Other Other Other Other Other Other Other Other
Restaurant main #GST kaam hone ke waje se bhi Hotels main kuch Fark nahi padha uspar actions Lena chahiye Tha @abpnewstv @aajtak	Other Other Other Other Other Other Other Other Other Other Other Other Other Other Other Other Other Other Other Other B-Org B-Org
.. Die hard voters bhi bol Rahe hai #gst ne dubo Diya.sab kehte hai Agli baar @narendramodi aana mushkil hai	Other Other Other Other Other Other Other Other Other Other Other Other Other Other Other Other B-Per Other Other Other
Kii baat nahi sir #Modibaters ke liye burnol #GST ke baat aur affordable ho gaya hai	Other Other Other Other Other Other Other Other Other Other Other Other Other Other Other Other
Aadhe #DeMonetisationDisaster mein chale gaye, aadhe #GST blunder mein chale gaye #IamModi akela apna naam ratne ko rah gaya	Other Other Other Other Other Other Other Other Other Other Other Other Other Other Other Other Other Other Other
Restaurant bill aur phone ke bill par 15 se 18 % tax lagne laga. I pay that. Isliye main andha Modi bhakt se sirf Modi bhakt rah gya	Other Other Other Other Other Other Other Other Other Other Other Other Other Other Other Other Other Other Other Other B-Per Other Other Other B-Per Other Other Other
Bhai Teri speed ne to desh ki Waat lagadi #GST itni speed mai lagaya CA ki bhi Samaj nahi aya #IamModi	Other Other Other Other Other B-Org Other Other Other Other Other Other Other Other Other Other Other Other Other Other Other
Rahul be like: Itana pyar to meri Maa ne bhi nahi kiya kabhi, rula dega kya pagle #GST #GSThelpdesk	B-Per Other Other Other Other Other
Av tk advocates ko smajh nhi aya #GST kya h? aur @narendramodi ji bol rhe h ki #behtar n #saral #GST	Other Other Other Other Other Other Other Other Other Other Other B-Per I-Per Other Other Other Other Other Other Other Other
Aare bhai... @OfficeOfRG tere ko state or city ka giyaan hie naahi hai... thu kiya ganith or #GST jaise aakshron ka giyan pada raha hai... aapkotho commedy wali baten aachi lagthi hai... plz irshad kijiye..	Other Other Other Other Other Other Other Other Other Other Other Other Other Other Other Other Other Other Other Other Other Other Other Other Other Other Other Other Other Other Other Other Other Other Other
Agar Ye report negative hoti to #DeMonetisation aur #GST ne desh ko duba Diya Par ab sab chup #easeofdoingbusiness #IndiaRising #EoDB	Other Other Other Other Other Other Other Other Other Other B-Org Other Other Other Other Other Other Other Other Other Other
Ab #RahulGandhi batayenge ki #GST kya hai. Phle gents toilet mei jao. #RahulBotAttack #rahulkigandisoch #gst #GabbarSinghTax	Other B-Per Other Other Other Other Other Other Other Other Other Other Other Other Other Other
Jumle ka julus niklega #gujarat mein tabhi to @ECI_India ne #GujaratElections2017 ko postpone kar di. Ye #GST aur hawai batein le dubegi	Other Other Other Other B-Loc Other Other Other Other Other Other Other Other Other Other Other Other Other Other Other Other Other
@PMOIndia Sir Pranam! #GST is indeed a landmark par kripya chamcho se kahein yeh sab na karein. 2019 mein sabsey bada Opposition yehi hai :)	Other Other Other Other Other Other Other Other Other Other Other Other Other Other Other Other Other Other Other Other Other Other Other Other Other
#khakra #GST @narendramodi ModiJi Chole Bhature, Chilli Potato Ka bhi price me kuch bargain ho jae too.	Other Other B-Per B-Per Other Other Other Other Other Other Other Other Other Other Other Other Other
#GST will be launched soon... saala ek line bhi #GST ka pata nahin hai	Other Other Other Other Other Other Other Other Other Other Other Other Other Other
Hum to bolte hain #GST aur #Demonetisation ko roll-back karo. Bharat mein zyada-se-zyada anpadh log hain,ye koi ko ATM-Paytm samajh mein nahi aa raha: Lalu Prasad Yadav	Other Other Other Other Other Other Other Other Other Other B-Loc Other Other Other Other Other Other Other Other Other Other Other Other Other B-Per I-Per I-Per
Beta ya to aap one rate' ke liye ladho, ya cap at 18%' ke liye. Dono ek sath na hove sake hai. #pidi #GST	Other Other Other Other Other Other Other Other Other Other Other Other Other Other Other Other Other Other Other Other Other Other Other Other
Election commission ko bhi @BJP4India par najar rakhni chahiye. Gujarat Haath se jaata Dekh ab #GST yaad aa gaya inhe	Other Other Other Other B-Org Other Other Other Other B-Loc Other Other Other Other Other Other Other Other Other Other
One rate of #GST @ 18% for all items? Not 0%, 5% & 12%? Yaane Takey Ser Bhaji, Takey Ser Khaja? Yaane Ki Kya Ye Aadmi @OfficeOfRG Paagal Hai Ye?!! #PagalPappu	Other Other Other Other Other Other Other Other Other Other Other Other Other Other Other Other Other Other Other Other Other Other Other Other Other Other Other Other Other Other B-Per
Free ka Lollipop ka Lalach dene wali Congress jab Tak sabhi chije 3/4% k slot me nahi aayegi tab tak logo ko #GST k khilaf bhadkana bandh karne wali nahi h	Other Other Other Other Other Other Other B-Org Other Other Other Other Other Other Other Other Other Other Other Other Other Other Other Other Other Other Other Other Other Other Other
Congress had #GST rate of 18% But RAM RAJYA has it at 28% .. Jai Sri RAM	B-Org Other Other Other Other Other Other B-Per Other Other Other Other Other Other Other B-Per I-Per
Na. Hotel rooms ab mehenge ho gaye #GST ke karan. Lodge leke jayega.	Other Other Other Other Other Other Other Other Other Other Other Other Other
Hamare sansad main baithe mantri is video ki bhali bhanti samajh payenge. #GST ne kya hall Bana diya	Other B-Org Other Other Other Other Other Other Other Other Other Other Other Other Other Other Other Other
Janta ki Paayi Paayi ka hisaab #GST se lene waale #Hitler Modi Ji apne Party Fund ki Paayi Paayi ka hisaab to pehle de do	Other Other Other Other Other Other Other Other Other Other Other B-Per Other Other Other Other Other Other Other Other Other Other Other Other Other
Is there any #CustomerCare available for anyone who is getting stuck ki yaar ab #gst ke baad ye karna ya nahi karna or kaise karna	Other Other Other Other Other Other Other Other Other Other Other Other Other Other Other Other Other Other Other Other Other Other Other Other Other
#GST ke baad se #NDTV ko reporting expensive pad rahi hai...TRP ke liye bhi aur Congress ke liye vote jutane ke liye bhi	Other Other Other Other B-Org Other Other Other Other Other Other Other Other Other Other B-Org Other Other Other Other Other Other Other
#GST is The new Duckworth Lewis method. Jo Aaj Tak Kisi ko samjh nhi aaya	Other Other Other Other B-Per I-Per Other Other Other Other Other Other Other Other Other
Aaj sare CA Ghar jake daru pine wale hai aur emotional baate krne wale hai.	Other Other B-Org Other Other Other Other Other Other Other Other Other Other Other Other
Apna chhoro aur un CAs ka socho jinhone 10 saal purane syllabus se parha aur ab kaam naye syllabus se karna parh raha hai	Other Other Other Other B-Org Other Other Other Other Other Other Other Other Other Other Other Other Other Other Other Other Other Other Other
Ab Ye Afwa Kon Faila Raha Hai Ki #GST Related Jokes Share Karne Par Mobile Ki Battery 12% Kam Ho Jaati Hai? :p	Other Other Other Other Other Other Other Other Other Other Other Other Other Other Other Other Other Other Other Other Other Other Other
Tab to bhai Abishek bachchan ko koi lena dena nahi hoga #GST se because wohi sabse jada baap ke cash pe aish karta hai	Other Other Other B-Per I-Per Other Other Other Other Other Other Other Other Other Other Other Other Other Other Other Other Other Other Other
Aaj Puri Raat Sabhi Liberals Or Sare Opposition Vale agle Kuchh dino Ka Negative Tweet Ka kota Ready krege	Other Other Other Other B-Org Other Other B-Org Other Other Other Other Other Other Other Other Other Other Other
desh chaahe jitna bhi badal jaaye, Parliament ke Central Hall mein lage huye pole waale fans kabhi nahi badlenge!	B-Org Other Other Other Other Other B-Org Other Other Other Other Other Other Other Other Other Other Other Other
Parliament ke day session me kai mantri log sote rehte hai ...to abhi kitne manti so rahe honge ..??	B-Org Other Other Other Other Other Other Other Other Other Other Other Other Other Other Other Other Other Other
Hema Malini is like samajh  main to aana nahi hai, khamakha raat ki neend kharab ki #gstrollout #GST	B-Per I-Per Other Other Other Other Other Other Other Other Other Other Other Other Other Other Other Other
India ke score se west indies ko 18% jyada score karna padega, kyuki unki batting 12 baje ke baad tak chalegi. #INDvWI #GST	B-Loc Other Other Other B-Loc I-Loc Other Other Other Other Other Other Other Other Other Other Other Other Other Other Other Other Other
Aur Kuch ho na ho #GST ki Wajah se Commerce ke baccho ka syllabus zarur chhota ho jayega #gstrollout	Other Other Other Other Other Other Other Other Other Other Other Other Other Other Other Other Other Other Other
Mallab nirbhaya ki headline isliye bani qki WO general thi ?	Other B-Per Other Other Other Other Other Other Other Other Other
Per ek baat hai samajwadi NE abhi bhi gayatri ko party se nahi nikala	Other Other Other Other B-Org Other Other Other B-Per Other B-Org Other Other Other
Kya ho raha hai? eik bachi ka rape hua aur usse mar dia. eik bande ko goli maar di aur ab eik aur bande ko 16 goliyaan mar di. The only son of his parents.. Intezar Siddique #JusticeForIntezar	Other Other Other Other Other Other Other Other Other Other Other Other Other Other Other Other Other Other Other Other Other Other Other Other Other Other Other Other Other Other Other Other Other Other Other B-Per I-Per Other
pagal ho rape jaise matter ko drag kar rahe ho itne se baat mein vote kyu nhi kiya jitne ke liye	Other Other Other Other Other Other Other Other Other Other Other Other Other Other Other Other Other Other Other Other Other
Ye haryana mein sach mein khatara sarkaar h. Ek aur rape haryana mein.	Other B-Loc Other Other Other Other Other Other Other Other Other B-Loc Other
Bharat desh mein jo niyamit roop se hota hai wo kuch or nahi rape hai..	B-Loc B-Org Other Other Other Other Other Other Other Other Other Other Other Other Other
3 din se Haryana main RAPE ke baat sun kar dil dahal Gaya 0 Kanoon vayvastha lachar ho chooki hai plz sir is bare main aap feedback leziye	Other Other Other B-Loc Other Other Other Other Other Other Other Other Other Other B-Org I-Org Other Other Other Other Other Other Other Other Other Other Other Other
Haryana me #AkhileshYadav ki govt aa gayi h kyaa???? Has #SamajwadiParty taken over Haryana???? Bahut rape ho...	B-Loc Other B-Per Other B-Org Other Other Other Other Other B-Org Other Other B-Loc Other Other Other
ye sab twitter per naam k aage rajput lagane se kuch nhi hota agar tumlog asal rajput ki paidaish ho to rape k against protest karo n i knw ki tumoog nhi_kroge cz tum khud ladkiyo ki respect nhi krte...	Other Other B-Org Other Other Other Other B-Org Other Other Other Other Other Other Other Other B-Org Other Other Other Other Other Other Other Other Other Other Other Other Other Other Other Other Other Other Other Other Other Other Other
hariyana me tumhare akaon ki hi sarkar hai jahan ladkiyon ka rape aur murder ho rahe hain us par debate nahi karoge	B-Loc Other Other Other Other Other Other Other Other Other Other Other Other Other Other Other Other Other Other Other Other Other
What the F**k!!! Again it happened jitna bhi bolo lekin ye kamine aadami ( culprit) sudharenge nahi kabhi 0 Phir se ek aur Nirbhaya ?	Other Other Other Other Other Other Other Other Other Other Other Other Other Other Other Other Other Other Other Other Other Other Other B-Per Other
Aur is vedio ko dekhne s pahle anuj loya ka press conference dekh lete to thoda bahut sharam aa jata besharam tujhe	Other Other Other Other Other Other Other B-Per I-Per Other Other Other Other Other Other Other Other Other Other Other Other Other
aurton ka rape karte ho salo procedure ke naam pe	Other Other Other Other Other Other Other Other Other Other
Nirbhaya case me verdict deke kaunsa upakar kar diya?? (without all due respect) Jo cheez ankho ke samne jo cheez ho usse bhi mukarne ki gujaish hoti h kya? Fir to Kasab ko saja sunane wale ko Bharat Ratn dede?	B-Per Other Other Other Other Other Other Other Other Other Other Other Other Other Other Other Other Other Other Other Other Other Other Other Other Other Other Other Other Other Other B-Per Other Other Other Other Other B-Loc Other Other
Yakub Menon aur Nirbhaya par nahi bole aap. Its fine moron Hindus like u ll not understand.	B-Per I-Per Other B-Per Other Other Other Other Other Other Other B-Org Other Other Other Other Other
Kis baat ka Proud kar rahi ho Maryam Safdar ? Tumari PMLN ke Goverment main 250 bachon k sath Rape howa Kasur main 0 Phir 12 bachiyo ko Rape k baad Murder kiya gaya. Kahan thi Police ? Tum Corrupt Family ke Security pa.	Other Other Other Other Other Other Other B-Per I-Per Other Other Other Other B-Org Other Other Other Other Other Other Other B-Loc Other Other Other Other Other Other Other Other Other Other Other Other Other Other B-Org Other Other Other B-Org Other Other Other
Koraput mein ek ladki ki gang rape hua Tha. 3 month ho Gaya kuch nai ho paya. Toh ladki ne suicide karliya aaj. Kya Kya ho raha Hai dunia mein	B-Loc Other Other Other Other Other Other Other Other Other Other Other Other Other Other Other Other Other Other Other Other Other Other Other Other Other Other Other Other Other
Kiran kher aaj aap keh rahi hain aaj se nahin saalon se ho rahe hain rape yeh Nirbhaya ke samay nahin socha tha tab to candle march nikalne main lagi thi	B-Per I-Per Other Other Other Other Other Other Other Other Other Other Other Other Other Other Other B-Per Other Other Other Other Other Other Other Other Other Other Other Other Other
Beheno! humlog Apne haq, education, career, safety, security ke liye to ladh nehi paaye aur na he humlog rape, female foeticide ko rok paaye. Wo bahut muskil kaam hai. chalo #Padmaavat ka release rokte hain, jaan dete hain	Other Other Other Other Other Other Other Other Other Other Other Other Other Other Other Other Other Other Other Other Other Other Other Other Other Other Other Other Other Other Other Other Other Other Other Other Other Other
Ye farzi hai, ye 15 lac jumla tha, #Achhedin gale ki Hadi hai, #GST main Congress ka hath hai, #demonitisation awara hai, #GDP down technical error hai, chai pokoda Vikas hai, Aug main bache marte hai, Haryana main rape fake hai. BC phir tum sab $&#&k mar rahe ho.	Other Other Other Other Other Other Other Other Other Other Other Other Other Other Other B-Org Other Other Other Other Other Other Other Other Other Other Other Other Other Other Other Other Other Other Other Other B-Loc Other Other Other Other Other Other Other Other Other Other Other Other
Rape ko rokne ke kadam uthane ki zimmedari aur samaaj ko sahi disha me rakhna , sarkaar ki zimmedari hai 0 Ye haryana ke molestor rapist dwara chuni gayi sarkaar hai kya ? Jo dharm ka paath khud nhi mante uska prachar band karein 0 Baap seedhe , bete harami hain bjp me voter kya honge ?	Other Other Other Other Other Other Other Other Other Other Other Other Other Other Other Other B-Org Other Other Other Other Other B-Loc Other Other Other Other Other Other B-Org Other Other Other Other Other Other Other Other Other Other Other Other Other Other Other Other Other Other Other Other Other B-Org Other Other Other Other Other
Atleast Kisi Ka Rape toh Nahi Horaha Aur Jahaan tak Target killing hai woh bhi Khatam Hogayi Hai	Other Other Other Other Other Other Other Other Other Other Other Other Other Other Other Other Other Other
Bhai tum log kahan se aate ho Achanak movie ke baare mein itna sochna tum log kahan Chale Jate Ho koi ladki ka rape Hota Hai aur usme Koi action nahi hota hai , aa gaye sab Moh Utha Ke	Other Other Other Other Other Other Other Other Other Other Other Other Other Other Other Other Other Other Other Other Other Other Other Other Other Other Other Other Other Other Other Other Other Other Other Other Other Other Other Other
Rape k against toh Kabhi in logon ko ladte Nahi dekha , aur ek movie se inko itniiii problem ??? Matlab itna C*yapa late Kaha se hai ye log ????	Other Other Other Other Other Other Other Other Other Other Other Other Other Other Other Other Other Other Other Other Other Other Other Other Other Other Other Other Other Other
#Hariyaana Me 5 Din me 5 Rape Ho Rahe Hai Aur Iss State Ki Government Ek Kalpanik Film Ko Ban Karne Me Lagi Hui Hai .... !	B-Loc Other Other Other Other Other Other Other Other Other Other Other Other Other Other Other Other Other Other Other Other Other Other Other Other Other Other
I believe aise logo ki best punishment hai inke Ek Ankh Ek Hath , Ek Paon n Rape Karne Wala part hi kat dena chahiye , Face pe engrave kar Dena chahiye Rapist	Other Other Other Other Other Other Other Other Other Other Other Other Other Other Other Other Other Other Other Other Other Other Other Other Other Other Other Other Other Other Other Other Other
Hahaha bhai aap chinta mat karo 0 Public ko sab pata hai in bikaau News channel ke bare me 0 Hamare Haryana me last 4 din me 6 gang rape huye hai par abhi tak kisi channel ne himmat nhi dikhayi hai debate karaane ki 0	Other Other Other Other Other Other Other Other Other Other Other Other Other Other Other Other Other Other Other Other Other B-Loc Other Other Other Other Other Other Other Other Other Other Other Other Other Other Other Other Other Other Other Other Other Other Other Other
Kabhi itni care agar Indian women aur children ki bhi kar lete to itne rape nahi hote anyways agla oped ka likh rahe hai Swarajya me Badte hue Rapes aur crime against women par #misplacedAttention	Other Other Other Other B-Loc Other Other Other Other Other Other Other Other Other Other Other Other Other Other Other Other Other Other Other Other Other Other Other Other Other Other Other Other Other Other
Ye bhi pad le tere asharam wale baba ab satta me aake teri maa bahno ka khule aam rape karte he aur tum unka support karte ho dallo	Other Other Other Other Other Other Other Other Other Other Other Other Other Other Other Other Other Other Other Other Other Other Other Other Other Other Other Other
Says the man jis ke tenure mein saare rape aur murders ke culprits ko sazaa ho chuki hai !!	Other Other Other Other Other Other Other Other Other Other Other Other Other Other Other Other Other Other Other
Hindustan b kamal hai , ek gadi me cow le jate hue log pakad liye jate phain , ladki ka rape and murder ho jata hai chalti car me but kisi ko pata ni chalta sadak pe	B-Loc Other Other Other Other Other Other Other Other Other Other Other Other Other Other Other Other Other Other Other Other Other Other Other Other Other Other Other Other Other Other Other Other Other Other Other Other
Nirbhaya ko to ab tak Justice nahi diya Congress ne fir bjp ko kyu involve kar rahe ho pehle apna kam dhang se Karo	B-Per Other Other Other Other Other Other Other B-Org Other Other B-Org Other Other Other Other Other Other Other Other Other Other Other Other
Pakistan mai kuchh fin pahle ek 7-8 saal ki bachhi ka rape ke baad murder kar diya gaya , sharam ki baat hai .. Indian social media dikha rahi ki Pakistan mai aise hota hai ! #kya Bharat mai nahi hota ?? #	B-Loc Other Other Other Other Other Other Other Other Other Other Other Other Other Other Other Other Other Other Other Other Other Other Other B-Loc Other Other Other Other Other B-Loc Other Other Other Other Other Other B-Loc Other Other Other Other Other
Beti bacha , Beti padhao ' campaign ko leke .. Haryana mein Fr ek beti ka rape Hua h ... Aur Humare leaders so re h .. Na aap logo se kuch Hua h Aur na hoga .. I FEEL SHAMED OF BIENG AN INDIAN #shameonindianleaders	Other Other Other Other Other Other Other Other Other Other Other Other Other Other Other Other Other Other Other Other Other Other Other Other Other Other Other Other Other Other Other Other Other Other Other Other Other Other Other Other Other Other Other Other B-Loc Other
Abhi kaha subah he time mileyga sheela @Shehla_Rashid ko ab abhi #JNU boys hostel mai #CondomAds k liye busy hogi	Other Other Other Other Other Other B-Per B-Per Other Other Other B-Org Other Other Other Other Other Other Other Other
Papa ne kaha thha Beta #JNU me kaise bhi karke Admission le lena .. Ab kehate nhi beta #DeshVirodhi nare dene se achha hai gharpe baith	Other Other Other Other Other B-Org Other Other Other Other Other Other Other Other Other Other Other Other Other Other Other Other Other Other Other Other
Kidhar Tukre ho rahe hain ?? Haan #JNU mee Kuch Anti social Creatures Shouted #BharatTereTukreHunge or tuo koi nahi bola	Other Other Other Other Other Other Other B-Org Other Other Other Other Other Other Other Other Other Other Other Other
par dande barsao 0 Sab theek ho jayega 0 #JNU	Other Other Other Other Other Other Other Other Other B-Org
Shame Kyunki koi admission lene main interested nahi hai is pagalkhane #JNU main !! Yeh toh hona hi tha !! Jaldi band bhi hoga !!!	Other Other Other Other Other Other Other Other Other Other Other B-Org Other Other Other Other Other Other Other Other Other Other Other Other Other
Hindustan tere tukde honge #JNU was abhivyakti ki Azadi .. @sonunigam ne bhi abhivyakti ki azadi ka fayda uthya nd now u becoming secular y?	B-Loc Other Other Other B-Org Other Other Other Other Other B-Per Other Other Other Other Other Other Other Other Other Other Other Other Other Other
kab chhodoge bhai hahaha India me sab to ccriminals hi hai ... Jitne bade naam hai sab .... Kon doodh ka dhula hua hai ek ka nam	Other Other Other Other B-Loc Other Other Other Other Other Other Other Other Other Other Other Other Other Other Other Other Other Other Other Other Other Other
Jis #AntiNationalist ka koi nahi hota uska @ndtv hota hai .. #JNU ka sahara @ndtv	Other Other Other Other Other Other Other B-Org Other Other Other B-Org Other Other B-Org
Wo sab to thik hai 0 Image of #JNU n TRP of @ndtv r same , like Shit 0 When ru finishing ur degree , Kab tak muft ki rotiyan todega	Other Other Other Other Other Other Other Other B-Org Other Other Other B-Org Other Other Other Other Other Other Other Other Other Other Other Other Other Other Other Other Other Other
chargesheet kya , Yeh raha combined judgement , hairani ki baat hai judge sahiba bhi #jnu se thi 0	Other Other Other Other Other Other Other Other B-Per Other Other Other Other Other Other B-Org Other Other Other
Another joke , shehla ne aaj chanel par pathar dikhaya , kankar tha , raat main badah hoh gaya #jnu	Other Other Other B-Per Other Other Other Other Other Other Other Other Other Other Other Other Other Other Other B-Org
violence abhi shuru kaha hua he , jab vo log vapas Bharat Murdabad ke naare lagate #jnu jese , tab violence hota 0	Other Other Other Other Other Other Other Other Other Other Other B-Loc Other Other Other Other B-Org Other Other Other Other Other Other
Sabhi college/university me padhai hoti h , pr #jnu me deshdrohi kand hote h ... freedom of speech ke nam pe ....	Other Other Other Other Other Other Other Other B-Org Other Other Other Other Other Other Other Other Other Other Other Other Other
@ArvindKejriwal ji car toh din rat chori hogai, atleast Sar-Kar toh smabhal ke rakhna. #delhipollution	B-Per I-Per Other Other Other Other Other Other Other B-Org Other Other Other Other Other
AAP ko tweet ke alawa kuch kaam nahi hai kya ??	B-Org Other Other Other Other Other Other Other Other Other Other
Kejri bawal to kuch nahi kar sakey ... Per bhagwan ne jarur barish kara di 0 Relief from #DelhiSmog #delhipollution 0 Be prepared for Kadakey ki thand. ;-)	B-Per Other Other Other Other Other Other Other Other Other Other Other Other Other Other Other Other Other Other Other Other Other Other Other Other Other Other Other
Sir, Sabke liye #Pollution Free Hawa ka samay aa gaya hai. #Gurgaon #India #DelhiSmog @PMOIndia @mlkhattar @cmohry	Other Other Other Other Other Other Other Other Other Other Other B-Loc B-Loc Other Other B-Per B-Per
Sarkar, phone call kar lijiye! Aaj Kal call rates Bohot kam ho gye hai. Some plans have free calls as well! #delhipollution #yokejrisoslow #delhiAirpollution	B-Org Other Other Other Other Other Other Other Other Other Other Other Other Other Other Other Other Other Other Other Other Other Other Other
Koi Dilli main bhi boond do boond baarish bhej do , we want to breathe #Frustration #delhipollution #DelhiGasChamber	Other B-Loc Other Other Other Other Other Other Other Other Other Other Other Other Other Other Other Other
jbki Haryana ne tested technology ki offer bhi kri hai isko lekin Delihi ki kismat footi hai to kya kre. ye chahta nhi ki Haryana ki help se #SmogInDelhi ka ilaaj ho 0	Other B-Loc Other Other Other Other Other Other Other Other Other Other B-Loc Other Other Other Other Other Other Other Other Other Other Other B-Loc Other Other Other Other Other Other Other Other
Agar aap desh mein laws implement sahi dhang se nahi kar sakte, to aap hume desh ke bahri dushmano se kaise bachaiyenge..? @narendramodi @PMOIndia @SupremeCourtFan @BJP4India ko ab apni gau mata ki chinta nahi hoti jisko bhi to saans lene mein dikat hogi #smogindelhi	Other Other B-Org Other Other Other Other Other Other Other Other Other Other Other Other B-Org Other Other Other Other Other Other B-Per B-Per B-Org Other Other Other Other Other Other Other Other Other Other Other Other Other Other Other Other Other Other Other
kaafi analysis se pta cha ki #smog jo hai wo sambhog se aaya hai, ramrahim or asaram jaise 4-5 baba ko arrest krlo khud hi chla jayega. no need of #OddEven then.	Other Other Other Other Other Other Other Other Other Other Other Other Other Other B-Per Other B-Per Other Other Other Other Other Other Other Other Other Other Other Other Other Other Other
Cabwala - Madam ji , yeh #Jio apni missus ko dila ke galti kardi 0 Jab dekho call hi karti rehti hai 0 Har minute ki khabar leti hai 0 #SoSad	Other Other Other Other Other Other B-Org Other Other Other Other Other Other Other Other Other Other Other Other Other Other Other Other Other Other Other Other Other Other Other Other
##Jio kuch bhi kar sakta hai ##	B-Org Other Other Other Other Other Other
aukat hi nahi hai Airtel afford karne ki	Other Other Other Other B-Org Other Other Other
yaar #jio yaha shop wala blak me jio phone becha raha h or hum advance diye bathe h unko phone mil nahi raha @yaduvansheesr	Other B-Org Other Other Other Other Other Other Other Other Other Other Other Other Other Other Other Other Other Other Other Other Other B-Per
Sab sathiya jaate h ! Inke employee khud #Jio use kar rhe hai New year ke bahane pata to chala ki	Other Other Other Other Other Other Other Other B-Org Other Other Other Other Other Other Other Other Other Other Other Other
Bhai , sab kuch free hi chahiye 0 Kyu koi fokat ki mahenat kare ? Sab kuch PM hi karenge 0 Hame bas baithe baithe #JIO k net se aisi tweet kare 0	Other Other Other Other Other Other Other Other Other Other Other Other Other Other Other Other Other Other Other Other Other Other Other Other Other B-Org Other Other Other Other Other Other Other
Jio free dekar bhi profit kar raha he 0 Or	B-Org Other Other Other Other Other Other Other Other Other
Super story of year ... paisa dega jaanta aur maaja uthaega company waaoo kiya answer hai #jio kaa 0 loogo ko stupid baana	Other Other Other Other Other Other Other Other Other Other Other Other Other Other Other Other B-Org Other Other Other Other Other Other
Saare peene wale wait kar rahe hain 0	Other Other Other Other Other Other Other Other
Kuch log bina recharge kiye hi #jio use kar rahe , kehte hai mera auto - recharge ho gaya 0	Other Other Other Other Other Other B-Org Other Other Other Other Other Other Other Other Other Other Other Other Other
Last one month se logon ko 4 G ke naam par 2 G net dekar thogo raha hai #Jio	Other Other Other Other Other Other Other Other Other Other Other Other Other Other Other Other Other Other B-Org
Ab sab recharge karane tayyar ho jao ..... JIO ka bhandara khatam hua ....	Other Other Other Other Other Other Other Other B-Org Other Other Other Other Other
Free ki khane walo tumhare din khatam ...	Other Other Other Other Other Other Other Other
Main apne bete ko smjha rha hun ki aise logo ki film nhi dekhni chahiye 0 #Jio & #Wikipedia hmare pas bhi hai 0 Canadian ki trah wo bhi ******	Other Other Other Other Other Other Other Other Other Other Other Other Other Other Other Other B-Org Other B-Org Other Other Other Other Other Other Other Other Other Other Other
mauka dekh k chauka mar diya , well done #PVSindhu	Other Other Other Other Other Other Other Other Other B-Per
Jiski Player Lambi ( 5'.10 ) uska ( India ) bhi bada naam hai #PVSindhu Agar Ch *** ya mil gaya toh jaldi use @ManishTewari ke paas bheje ...... I repeat jaldi bheje .... he	Other Other Other Other Other Other Other Other B-Loc Other Other Other Other Other B-Per Other Other Other Other Other Other Other Other Other B-Per Other Other Other Other Other Other Other Other Other Other
Haro toh ESA haro ki haar mai bhi jeet ho #PVSindhu #Champiom	Other Other Other Other Other Other Other Other Other Other B-Per Other
Ek to #PVSindhu refree ko kuch maan hi nhi rahi	Other Other B-Per Other Other Other Other Other Other Other
Badminton kya hai wo bhi nahi janne wale log	Other Other Other Other Other Other Other Other Other
Dhara Bibaranee on Twitter by Sanjaya ~ Sambit Bhai 0	Other Other Other B-Org Other B-Per I-Per I-Per I-Per Other
Inhi se puppy paida huye hain bhai ... abhi ashutosh ji ne	Other Other Other Other Other Other Other Other Other B-Per I-Per Other
Apne desh mei content ki bhi barsaat ho rahi hai #tripletalaq #righttoprivacy #rapistbaba #china #MumbaiRains	Other B-Org Other Other Other Other Other Other Other Other Other Other Other B-Loc Other
Ab to bhai Adhar geya tel lene #RightToPrivacy	Other Other Other Other Other Other Other Other
Badi begairat , jumlebaj hai government	Other Other Other Other Other B-Org
Khudko khuli kitaab bolne wale bhi #RightToPrivacy par tweet kar rahe hai 0	Other Other Other Other Other Other Other Other Other Other Other Other Other
Ab #sunnyleone ke porn video jo ek hi shaksh #robert ke sath dikhaane waalo ki kadi ninda ki jaayegi .. #RightToPrivacy	Other B-Per Other Other Other Other Other Other Other B-Per Other Other Other Other Other Other Other Other Other Other Other
Train Me Mobile Chori Karne wale to pakde hi nahi jaate 0 Chhin Ke Bhag Jaate Hai BC #RightToPrivacy	Other Other Other Other Other Other Other Other Other Other Other Other Other Other Other Other Other Other Other
Ravi Shankar Prasad on #RightToPrivacy 0 This is priceless	B-Per I-Per I-Per Other Other Other Other Other Other
Yeh protect our privacy waale wahi log hai jo #Sarahah App use karte hai aur screenshot post karte hai #RightToPrivacy	Other Other Other Other Other Other Other Other Other B-Org I-Org Other Other Other Other Other Other Other Other Other
Saari duniya ko FB pe batayenge kahan gaand marwa rahe hain tab inhe yaad nahi aata par #Aadhar dangerous hai 0 #RightToPrivacy	Other Other Other B-Org Other Other Other Other Other Other Other Other Other Other Other Other Other Other Other Other Other Other
Â 	Other
G2 - kar toh raha hu bas fark yeh ki usey apney notepad pe kar raha #RightToPrivacy bro	Other Other Other Other Other Other Other Other Other Other Other Other Other Other Other Other Other Other
Tumhe apne desh pe bharosa nahi par VISA ke time dusare desh pe bada bharosa dikhate ho ? #Aadhaar #RightToPrivacy	Other Other B-Org Other Other Other Other Other Other Other Other B-Org Other Other Other Other Other Other Other Other
Oh Mukesh bhai samne or Anil bhai upar ki floor pr na , muje sab pata hai chupa mat under #RightToPrivacy me	Other B-Per I-Per Other Other B-Per I-Per Other Other Other Other Other Other Other Other Other Other Other Other Other Other Other
#America me #Trump ke khilaf chunav ladte to pakka jeet gaye hote 0	B-Loc Other B-Per Other Other Other Other Other Other Other Other Other Other
Mubarak ho ... #UP ko #Trump hua hai ... #YogiAdityanath	Other Other Other B-Loc Other B-Per Other Other Other B-Per
Koun kahta hai modi ji kam nahi kar rahe 4 mahine mein hi #Trump ka replica bana diya .... #YogiAdityanath	Other Other Other B-Per I-Per Other Other Other Other Other Other Other Other B-Per Other Other Other Other Other B-Per
Sunne me aya hai k Yogi ji 7 Muslims states ko ban krne ki baat kr rhe hain #Trump k competition mein 0 Inko koi smjhao yr yeh US nhi UP hai	Other Other Other Other Other B-Per I-Per Other B-Org I-Org Other Other Other Other Other Other Other Other B-Per Other Other Other Other Other Other Other Other Other B-Loc Other B-Loc Other
#trump ko jawab de kar pehli martaba Imran khan ne koi aisa kaam kiya hai ke jis par awam ki nazar ache mahno main us par gai hai #PMLN	B-Per Other Other Other Other Other Other B-Per I-Per Other Other Other Other Other Other Other Other Other Other Other Other Other Other Other Other Other Other Other B-Org
Sirf Trump jo bole wahi yaad hai ek kaan mein ? Jo #Modi bole wo bhi yaad rakho na : EAM to oppn on #Trump	Other B-Per Other Other Other Other Other Other Other Other Other Other B-Per Other Other Other Other Other Other Other Other Other Other Other B-Per
@ajmaljami Ab to khudara apnay Dr 0 Sb sey poochiye k #Trump aur #Modi sattu pee k so gaye kya , yhan un ka yaar to gaya ! :) @Xadeejournalist	B-Per Other Other Other Other Other Other Other Other Other Other B-Per Other B-Per Other Other Other Other Other Other Other Other Other Other Other Other Other Other Other B-Per
#Trump ko di #eBay ne Supari , kehekar khatam kardo #Amazon Naam ki bimari 0	B-Per Other Other Other Other Other Other Other Other Other B-Org Other Other Other Other
Kuch na mile to #America pe daal dain ; apko waqae lagta hai #Trump itna jahil hai k in sub ko use kare ga ???	Other Other Other Other B-Loc Other Other Other Other Other Other Other Other B-Per Other Other Other Other Other Other Other Other Other Other Other
Maza toh tab aayega jab #trump terror ko khatam karega	Other Other Other Other Other B-Per Other Other Other Other
Dhande se bada koi #climatedeal nai hota 0 Uff ... Baniye ka dimag aur TrumpBhai ki daring #Parisagreement	Other Other Other Other Other Other Other Other Other Other Other Other Other Other B-Per Other Other B-Loc
Sue ho gayi hai ye gormint 0	Other Other Other Other Other Other Other
Aur iske saath hi RDX sir ne #Syria pe bambari karke ye elaan kar diya ke abhi hum  zinda han Agar IK #Trump ko bura samajh raha hai to matlab kuch to achha hai humare Trump mai 0	Other Other Other Other Other Other Other B-Loc Other Other Other Other Other Other Other Other Other Other Other Other Other Other B-Per Other Other Other Other Other Other Other Other Other Other Other Other B-Per Other Other
Bechara #Pakistan bhikari ho Gaya , Hai na @MaryamNSharif @CMShehbaz ab katora le Kar Kaha jaoge , #trump ne 190 million USD ka jhatka Jo diya	Other B-Loc Other Other Other Other Other Other B-Per B-Per Other Other Other Other Other Other Other B-Per Other Other Other Other Other Other Other Other
Haan bhai kyun nahi ? Obama tere ghas me ghuske teri sote hue photos bhi leta hai !! #TRUMP #Obama	Other Other Other Other Other B-Per Other Other Other Other Other Other Other Other Other Other Other Other B-Per B-Per
agar nawaz sharif sy kuch nahi ho sakta to hum #Trump ko 11 Sep 2001 ki yad dila dety Hain Phir sy ..	Other B-Per I-Per Other Other Other Other Other Other Other B-Per Other Other Other Other Other Other Other Other Other Other Other Other
Koi #Trump ko samjhai jahil ki dosti se behter hai aqalmand ki dosti :-)	Other B-Per Other Other Other Other Other Other Other Other Other Other Other Other
#SaveDrDeenMohdBaloch @NarendraModi ji balochistan ka mudda uthaiye #Trump ke samne	Other B-Per I-Per B-Loc Other Other Other B-Per Other Other
#Trump k byan pay China , Russia , Iran  sab bolay par nawaz sharif nai bola Agar waqai aisay hai tu iss se ziada bezti nahi ho sakti #Trump ki	B-Per Other Other Other B-Loc Other B-Loc Other B-Loc Other Other Other B-Per I-Per Other Other Other Other Other Other Other Other Other Other Other Other Other Other B-Per Other
#trump or america k jawab Dana k baje mujhe block krdo gi or TM kr b kiya sakti ho	B-Per Other B-Loc Other Other Other Other Other Other Other Other Other Other Other Other Other Other Other Other
@KhawajaMAsif even said we did never take dollars .. Yar khuda ka khoof kro #Trump ny raseeden nikal leni hain	B-Per Other Other Other Other Other Other Other Other Other Other Other Other Other B-Per Other Other Other Other Other
#Trump ka toh #Ban chalo samajh me aata hai 0 Lekin ye #kuwait wale kab se #RSS ke #Agent ho gaye 0	B-Per Other Other Other Other Other Other Other Other Other Other Other B-Loc Other Other Other B-Org Other Other Other Other Other
Azad Hindustan ka har hissa deshwasiyon ka hai ! Har street me ek Hindustani bolega aur dusra sunega ! #RSS / #BJP / #Modi ki taqat hae Rok	Other Other Other Other Other Other Other Other Other Other Other Other Other Other Other Other Other Other Other Other Other Other Other Other Other Other Other Other
Paki media Chilla rhi #TRUMP ne #Dhamkaya hai !	B-Org I-Org Other Other B-Per Other Other Other Other
#flightmodepm	Other
Yaar sirf sher sher krty rahna kabhi #trump ki tweet pr bhi reply kroo 0 Ya hum ny apis main hi sari umer larty rahnaa	Other Other Other Other Other Other Other B-Per Other Other Other Other Other Other Other Other Other Other Other Other Other Other Other Other Other
Badhai ho badhai #Pakistan #terror #India Pakistan ko milane wali madad ko shriman #trump ji ne rok diya jai ho	Other Other Other B-Loc Other B-Loc B-Loc Other Other Other Other Other B-Per I-Loc I-Loc Other Other Other Other Other
Isi tarah Tum dono ek dusre ke pol kholte raho 0 Very good 0 #Trump #TrumpDumpsPak	Other Other Other Other Other Other Other Other Other Other Other Other Other Other B-Per Other
Kya De kock vo bhi dusri country ka hum apne desh me rahke dusre ka WK kaise soch sakte he	Other B-Per I-Per Other Other Other Other Other Other Other B-Org Other Other Other Other Other Other Other Other Other
Eng khali haath aaye the , khaali haath jaa rhe hain .. haha #INDvENG #T20 #Viru #Kohli	Other Other Other Other Other Other Other Other Other Other Other Other Other Other Other B-Per B-Per
www 0 bbc 0 co 0 uk / music / artists / fdf 25 d 7 c - d 8 f 4-4736- ad 24- bf 2286 a 61254	Other Other Other Other Other Other Other Other Other Other Other Other Other Other Other Other Other Other Other Other Other Other Other Other Other Other Other Other
Aaj to 3 hr ke liye to #Toilet Bhi koi Nahi Jayega	Other Other Other Other Other Other Other Other Other Other Other Other
Khali road ho awr Pose na ho	Other Other Other Other Other Other Other
SP BSP CONG ki career hi kharab kar di ....	B-Org B-Org B-Org Other Other Other Other Other Other Other
shuru karo Patriotic ban na , le kar #IndVAus ka naam	Other Other Other Other Other Other Other Other Other Other Other
Are yar jaldi se release kr do bhai 0 Wait nahi ho rha h India ki har pe khusi mile the Sir jadeja ... Jab jaroorat ho to ek rajpoot ko bhejna padega .. #kohli #captaincy #sir #jadeja	Other Other Other Other Other Other Other Other Other Other Other Other Other Other B-Loc Other Other Other Other Other Other Other B-Per Other Other Other Other Other Other B-Org Other Other Other Other B-Per Other B-Per I-Per
Sachin Ramesh Tendulkar !!!!! by Rajesh Seshadri :	B-Per I-Per I-Per Other Other B-Per I-Per Other
#kohli aur #rohit ki running dekh ke lag rha ki aaj dono run - out nhi hone wale ... #INDvAUS @BCCI	B-Per Other B-Per Other Other Other Other Other Other Other Other Other Other Other Other Other Other Other Other Other B-Org
#virupanti Ager #Dhawan aur #Rahane ke bich confusion hai ki kon opening karga ?? .. to kyu na #Rohit ko middle order me khilaye ....	Other Other B-Per Other B-Per Other Other Other Other Other Other Other Other Other Other Other Other Other B-Per Other Other Other Other Other Other
People tweeting as if he retired 0 Abhi Maahiya khelega re 0 Bas kaptaani chhodi hai , Chilean nahi 0 #Dhoni	Other Other Other Other Other Other Other Other Other Other Other Other Other Other Other Other Other Other Other Other Other
#Dhoni ki captaincy chhodne ki khabar sunkar Gambhir ne party dene ke liye , bank se personal loan bhi apply kar diya hai 0	B-Per Other Other Other Other Other Other B-Per Other B-Org Other Other Other Other B-Org Other Other Other Other Other Other Other Other Other
Modiji jawab de #Dhoni ne retirement kyu li hai ? Varna me pure bharat me ghum ghum k pata lagauga	B-Per Other Other B-Per Other Other Other Other Other Other Other Other Other B-Loc Other Other Other Other Other Other
Jab Keeper ka role nibhaya to kya khoob nibhaya aur jab skipper ka to kehne hi nahi .. TRUE spirit #Dhoni .. Growing thru life is imp ..	Other Other Other Other Other Other Other Other Other Other Other Other Other Other Other Other Other Other Other Other B-Per Other Other Other Other Other Other Other
#Dhoni captain cool , ekdum cool ho k nikal liye ... #respect	B-Per Other Other Other Other Other Other Other Other Other Other Other
Itni tension raina ko 8 nov k baad nhi hui hogi jitni aaj ho rhi hogi 0 #dhoni #ThankYouDhoni #legend	Other Other Other Other Other Other Other Other Other Other Other Other Other Other Other Other Other B-Per Other Other
Dhoni be like : acha chalta hu captaincy me yaad rakhana #Dhoni	B-Per Other Other Other Other Other Other Other Other Other Other B-Per
#dhoni mara nahi hai Captain se istifa diya hai , lage pade hai log ...	B-Per Other Other Other Other Other Other Other Other Other Other Other Other Other Other
What a person , salute hai tumhe #Dhoni ....... tum logo Ki najar me aur bade Ho gaye ..... Keep it up ......	Other Other Other Other Other Other Other B-Per Other Other Other Other Other Other Other Other Other Other Other Other Other Other Other
#Dhoni Ki Ulti Ginti Shuru â¦ Yehi Waqt Ki Chaal â¦ Aage Aage Dekhiye Hota Hai Kya ??? â feeling awesome	B-Per Other Other Other Other Other Other Other Other Other Other Other Other Other Other Other Other Other Other Other Other
Kholi ke wajah se captainship chori hai ..	B-Per Other Other Other Other Other Other Other
End of an era !!! Apna Captain Mahi jaa rha hai :(	Other Other Other Other Other Other Other B-Per Other Other Other Other
Sir why #Dhoni hame pata hai isme #soravgaguliy ka hath hai new paresident bante hi @BCCI	Other Other B-Per Other Other Other Other B-Per Other Other Other Other Other Other Other B-Org
#Dhoni misbah bhai kuch sikh Captain saahab se 0	B-Per B-Per Other Other B-Org Other Other Other Other
Yuvraj Singh ka baap bht khush hoga aaj ... Ghatiya insaan #India loves you #Dhoni	B-Per I-Per Other Other Other Other Other Other Other Other Other B-Loc Other Other B-Per
Dhoni ke retirement ke baad ab salman ke retirement ki bhi hawa chal rahi hai	B-Per Other Other Other Other Other B-Per Other Other Other Other Other Other Other Other
are madarchod rahul tere sare khandan ne is country ko bus luta hai or kuch nahi	Other Other B-Per Other Other Other Other Other Other Other Other Other Other Other Other Other
#RahulGandhi ki aisi chali andhi hathi ki akho me pad gyi dhul , hathi gira dhadam se 0 ban gya gaddha 0 gaddhe me gir gyi cycle #JaiRamji	B-Per Other Other Other Other Other Other Other Other Other Other Other Other Other Other Other Other Other Other Other Other Other Other Other Other Other Other Other
Mummy agar hume #YogiAdityanath ko rokna hai toh #Rock & #JasonStatham ko party me shaamil Karna padega : #RahulGandhi	Other Other Other B-Per Other Other Other Other B-Per Other B-Per Other Other Other Other Other Other Other B-Per
@aajtak @abpnewstv @ZeeNews #Rahulgandhi spotted in puri 0 Dhabli bjate hue during rath yatra 0	B-Org B-Org B-Org B-Per Other Other B-Loc Other Other Other Other Other Other Other Other
#Rahulgandhi sir itna shark size ka ghotala kiya aapke porkho ne to ab zabab dena aapki duty hai agar dam hai to acepted kiziye nehi to ham innocent hai bata do .......	B-Per Other Other Other Other Other Other Other Other Other Other Other Other Other Other Other Other Other Other Other Other Other Other Other Other Other Other Other Other Other Other Other
Main samajhta hun jitna paisa wo daalte hain publicity mein humen daalna bhi nahi chahiye kyunki ye sa	Other Other Other Other Other Other Other Other Other Other Other Other Other Other Other Other Other Other
#RahulGandhi	B-Per
#RahulGandhi .. bhiwandi n malegaon ki jeet mubarak 0 congress ki jeet media nahi batati .. yahan se jeet ki shroowat ho gayee hai ...	B-Per Other B-Loc Other B-Loc Other Other Other Other B-Org Other Other Other Other Other Other Other Other Other Other Other Other Other Other Other
Narendra Modi kehte hain mitron Ganga maa ne Gujarat se apne bete ko bulaya hai , ek hi beta hai kya Ganga maa ka ?	B-Per I-Per Other Other Other B-Per I-Per Other B-Loc Other Other Other Other Other Other Other Other Other Other Other Other B-Per I-Per Other Other
Pehle Congress party ko khatam kiya ab samajwadi party ki baari hai !! #RahulGandhi	Other B-Org Other Other Other Other Other B-Org I-Org Other Other Other Other B-Per
Hahhaa #MakeInIndia project tha wo .. sanskari bomb hoga 0 Waise iss ghatna ka #amitshah ke #Kerala dauure se koi samband nahi hoga 0 Hain na ???.	Other Other Other Other Other Other Other Other Other Other Other Other Other Other B-Per Other B-Loc Other Other Other Other Other Other Other Other Other Other
India mai film making saalon se chala aarah hai 0 RB Rathor ne Isko bhee modi ji ke #MAKEININDIA se link ker diya 0	Other Other Other Other Other Other Other Other Other Other B-Per I-Per Other Other Other B-Per I-Per Other Other Other Other Other Other Other
#MakeInIndia bola to Modi promotion ho jata 0 Babbarsher wala 0	Other Other Other B-Per Other Other Other Other Other Other Other
Aaj ki date me mobile bhi #MakeInIndia pe based hai idiot	Other Other Other Other Other Other Other Other Other Other Other
Please help Mr 0 Modi ( P 0 M ) aap ko ese ke meter me application bheja gaya tha ( speed post EJ 330955044 IN ) uspe koe karwae ni hua	Other Other Other Other B-Per Other Other Other Other Other Other Other Other Other Other Other Other Other Other Other Other Other Other Other Other Other Other Other Other Other Other Other
#MakeInIndia CONGRESS APNEE GUNAAHOO KE WAJAH SE MUKT HUI HAIN BHARAT SE ... NE KI DOOSROO KI WAJAH SE .... CONGRESS MUKT BHARAT BAANEGA 0	Other B-Org Other Other Other Other Other Other Other Other Other Other Other Other Other Other Other Other Other Other B-Org Other Other Other Other
This generation is gonna cross limits kyuki hame wahi sunne me maze aate hai jo ham khud k liye sunna nhi chaahte 0	Other Other Other Other Other Other Other Other Other Other Other Other Other Other Other Other Other Other Other Other Other Other Other
Â 	Other
Sahab logo ki #MannKiBaat sunne s accaha hai zaara apne party kaho karm karei faal k ichaa na karei #JantaSaabJanti hai , wt for new change	Other Other Other Other Other Other Other Other Other Other Other Other Other Other Other Other Other Other Other Other Other Other Other Other Other Other
Haha ... sahi hai ... Twitter pe naukri nahi karta kisi ki 0	Other Other Other Other Other B-Org Other Other Other Other Other Other Other
#MannKiBaat ka Naam Badal kar desh ki baat honi chahiye kabhi safai ki baat kabhi Kisan ki baat different different name ..:)	Other Other Other Other Other B-Org Other Other Other Other Other Other Other Other Other Other Other Other Other Other Other Other
#MannKiBaat sir jab aap food grans ke price jamien per laye ge to aap ke sab koshis puri hogi	Other Other Other Other Other Other Other Other Other Other Other Other Other Other Other Other Other Other Other
Aur ham kuch bol de to log anti - national bol ke maar jaate hai	Other Other Other Other Other Other Other Other Other Other Other Other Other Other Other
Mujhy shaq hua k unhy jabarjasti bhekh mangbai ja rahi h toh mainy police ko inform kiya , ab be bachchy bekh nai mangty	Other Other Other Other Other Other Other Other Other Other Other Other Other Other Other Other Other Other Other Other Other Other Other Other
U know shariyat or we 0 we have learnt & understood 0 kaun gumraah kar raha ye 2014 se dekh rahe aur sun rahe #MannKiBaat	Other Other Other Other Other Other Other Other Other Other Other Other Other Other Other Other Other Other Other Other Other Other Other Other Other
Sant rampalji nirdosh hai un par lagaye sabhi 0 cases vapas liye jaye	B-Per I-Per Other Other Other Other Other Other Other Other Other Other Other
#MannKiBaat judges ki jawabdehi honi change , Saint Rampal ji ke cases ki CBI jaanch ho 0	Other Other Other Other Other Other Other B-Per I-Per I-Per Other Other Other B-Org Other Other Other
sant rampalji ke upr ek bhi kes nhi huaa siddh fir jail me kyo rkha riha	B-Per I-Per Other Other Other Other Other Other Other Other Other Other Other Other Other Other
Haryana Sarkar hi Dosi hai ye photo Garhwali Dete Hain Ki Sant Rampal Ji Maharaj Nirdos	B-Loc Other Other Other Other Other Other Other Other Other Other B-Per I-Per I-Per I-Per Other
Kya simple hai ??? Hahahahahahaha ... Tamasha Party ... aloo ki factory lagvao tum , dekho wo kitna simple hai !!! Tu wahi hai na Jisne #SurgicalStrike ko Jhooth kaha tha , Tu aur Tera Mallik itna hi simple @INCIndia Yeh frustration tum logo k chehre pr mujhe achha laga ! Yeh #DeMon #GST #SurgicalStrike #NIAHuriyat #ZakirNaik #Benami #Aadhar #TrippleTalaqBan etc k ghaav tum logon ko ghinone mooh pe ache lage . Aiyyar ka culture DeshDroh hai Jo China ko MaaiBap manta Hai ! #ShameOnYou	Other Other Other Other Other Other Other Other Other Other Other Other Other Other Other Other Other Other Other Other Other Other Other Other Other Other Other Other Other Other Other Other Other Other Other Other Other Other Other Other Other Other Other Other Other Other Other Other Other Other Other Other Other Other Other Other Other Other Other Other Other Other Other Other Other Other Other Other Other Other Other Other Other Other Other Other Other Other Other Other Other Other Other Other Other
SAALA SAB BUSY HAI desh KO AAGE BHADANE .. LOL .. GHANTA KHANOON .	Other Other Other Other B-Org Other Other Other Other Other Other Other Other Other
Jab khud pe ayi to lets not politicise ?	Other Other Other Other Other Other Other Other Other
Bhai aisa hai na ki india ko america pe #SurgicalStrike karne ki jaroorat nhi pdi thi #chutiyaThoughts	Other Other Other Other Other Other Other Other Other Other Other Other Other Other Other Other Other
#surgicalstrike ek baat aur @narendramodi sir ... Prasar Bharti mein baithe @sunilalagh Jo damaad Samir Nair CEO Balaji ki jeb bharte hain	Other Other Other Other Other Other Other Other Other Other Other Other Other Other Other Other Other Other Other Other Other Other
Ab karo #surgicalstrike & do the show - off .. Modi Modi karne se kuchh nahi hoga , jawan marte rahenge & ye bhaio behno karte rahenge	Other Other Other Other Other Other Other Other Other Other Other Other Other Other Other Other Other Other Other Other Other Other Other Other Other Other Other
Ek #surgicalStrike #reservation system pe v jaruri hai , hmlog category dekh k naukari dete hai isliye hmlog	Other Other Other Other Other Other Other Other Other Other Other Other Other Other Other Other Other Other
Kuch din baad se me ye deshdrohi o ka twitter me tweet ke jariye se #SurgicalStrike karunga . Tab tak ke liye alvida mere dosto . Jai Hind .	Other Other Other Other Other Other Other Other Other Other Other Other Other Other Other Other Other Other Other Other Other Other Other Other Other Other Other Other Other
Ek badi aayu ke sardar mujhse kahein ki meri ek iccha hai , mujhe bhi Pak ki seema pe duty de do , ek aur #surgicalstrike ka mauka de do - PM	Other Other Other Other Other Other Other Other Other Other Other Other Other Other Other Other Other Other Other Other Other Other Other Other Other Other Other Other Other Other Other Other
.. remember during #surgicalstrike ? He was silent . So kuch to zaroor hoga . yeh balidaan khali nahi jaiga	Other Other Other Other Other Other Other Other Other Other Other Other Other Other Other Other Other Other Other Other
Are beimano #SurgicalStrike pe tumhi log Pakistan ki tarah evidence mang rahe thena ??? Tumhara Fake Emotion sab Hindustani jan chuke he ab !	Other Other Other Other Other Other Other Other Other Other Other Other Other Other Other Other Other Other Other Other Other Other Other Other
Kyu Abhi 28 sept . 2016 Ki Raat jo Action Dhamaal hua wo #American #Army ne ki thi ,	Other Other Other Other Other Other Other Other Other Other Other Other Other Other Other Other Other Other Other
Aur is baar jo proof maange , chahe wo khi ka #CM hi q na ho , seedha #Goli _ maar _ do _ unko _ V	Other Other Other Other Other Other Other Other Other Other Other Other Other Other Other Other Other Other Other Other Other Other Other Other Other Other Other
aur ye #SurgicalStrike ka proof maang rahaa tha	Other Other Other Other Other Other Other Other
Sir ye @sanjaynirupam wahi hain na jo #SurgicalStrike ka proof manga tha ? Sayad mil gaya #BMCresult	Other Other Other Other Other Other Other Other Other Other Other Other Other Other Other Other Other
Looks like Pak needs #SurgicalStrike again .. laato ke bhoot baato se nai maante ..	Other Other Other Other Other Other Other Other Other Other Other Other Other Other Other
Aisa #surgicalstrike kiya ki #pak ne #napak irado se #ind k 2 laadle bete ka sir kaat diya , sirf vote k liye # 56 inch ka sina kahna galat hai	Other Other Other Other Other Other Other Other Other Other Other Other Other Other Other Other Other Other Other Other Other Other Other Other Other Other Other Other Other Other Other
#surgicalstrike ka hal dek kar tho ab indian army nay b haat karay kar dye keh ab bas . kaheen koi saboot na mang ly .	Other Other Other Other Other Other Other B-Org I-Org Other Other Other Other Other Other Other Other Other Other Other Other Other Other Other Other Other
#SanjayNirupam without proff joint isis isi @RSSOrg pe Arop but ek Malegaon yaad hai lekin unk kud k State pe jab #MumbaiTerrorAttack hua woh yaad nahi rakh pata nahi Kyun ?7 Otr #SivsenaBuildingBlast Impact of #DeMonetisation and #SurgicalStrikeonBlackMoney #SurgicalStrikes against Terror State Porkistan by our PM Modi ji .	Other Other Other Other Other Other Other Other Other Other Other Other Other Other Other Other Other Other Other Other Other Other Other Other Other Other Other Other Other Other Other Other Other Other Other Other Other Other Other Other Other Other Other Other Other Other Other Other Other
Jab WhatsApp me admin ek hi hoga tho talent ese niklega ! Mujhe tho ea vi doubt he inhe aapna khud ka naam likhna vi aata he ya n	Other Other Other Other Other Other Other Other Other Other Other Other Other Other Other Other Other Other Other Other Other Other Other Other Other Other Other Other Other
Aajkal sc high court mjak ban kr rah gyi he usnke pass millions of case panding pade he pr unko ye faltu ke case pahle dikhte he #Dipawali pe pathake band #holi pe pani band #jalicattu me atyachar pasuo par gay khao savidhan ne azadi di he Vahhh me desh ke sc #ZeeNews	Other Other Other Other Other Other Other Other Other Other Other Other Other Other Other Other Other Other Other Other Other Other Other Other Other Other Other Other Other Other Other Other Other Other Other Other Other Other Other Other Other Other Other Other Other Other Other Other Other B-Org Other Other Other
Celebrate more kyunki #MithaasKeRang honge aur bhi gehre #Holi ke sang .	Other Other Other Other Other Other Other Other Other Other Other Other
@chetan _ bhagat Ab #Diwali se pollution hota hai bolane wale buddhijivi mahajan gaye .	Other Other Other Other Other Other Other Other Other Other Other Other Other Other Other
Hum #Holi khelenge aur khub khelenge . Pani se ke sath hi khelenge . Saare opponents patli gali se nikal jao .	Other Other Other Other Other Other Other Other Other Other Other Other Other Other Other Other Other Other Other Other Other Other
#Delhi walo , Taiyaar ho jao . #Diwali aa rahi hai ! Last time waala #Pollution ka record todna hai !	Other Other Other Other Other Other Other Other Other Other Other Other Other Other Other Other Other Other Other Other Other
Diwali bonus aa gaya hai . Koi group chhodke jana mat . Fursat milte hi baant diya jayega .	Other Other Other Other Other Other Other Other Other Other Other Other Other Other Other Other Other Other Other
#Holi Ab ki baar hum khele aisi Holi dekhne wale dekhte rah jayenge ye intellectuals ke rang ud jayenge	Other Other Other Other Other Other Other Other Other Other Other Other Other Other Other Other Other Other Other
Diwali Shopping wahan se karo jahan kisi gareeb ki Diwali achi hojaye #Diwali #deepavali	Other Other Other Other Other Other Other Other Other Other Other Other Other Other
dekho dekho Papu ke chamcha ko breaking story mil gaya .... congrats ! is #Diwali chamcha k naam	Other Other B-Per Other Other Other Other Other Other Other Other Other Other Other Other Other Other Other
Jo apna kaam dhanda chod kar sirf #Hindu #festivals ko ban kare wo #SupremeCourt 0	Other Other Other Other Other Other Other Other Other Other Other Other Other Other Other
Jyada padhna bhi kharaab hota hai .... Kya Supreme Court ke Chief Justice ne bachpan se bina patakhe ke #Diwali Manayi hai ....?	Other Other Other Other Other Other Other Other B-Org I-Org Other Other Other Other Other Other Other Other Other Other Other Other Other
Is baar hum #Diwali thodi alag aur hatke manayenge ! Bolo yeh idea kaisa hai ? Kuch Daag ache hote hai !	Other Other Other Other Other Other Other Other Other Other Other Other Other Other Other Other Other Other Other Other Other Other
Yeh jo madarchood cracker free #Diwali ki baat Kar rahe hai woh betichood pure saal toh AC chalate hai , aur cars se pollution karte hai	Other Other Other Other Other Other Other Other Other Other Other Other Other Other Other Other Other Other Other Other Other Other Other Other Other Other
Lo ji abhi tak to #Bitcoin hi logo ka nind ura raha tha 0 Ab is #Ethereum ko bhi gudgudi hone lgi 0 #Ethereum ka rate is bhaging ...	Other Other Other Other Other Other Other Other Other Other Other Other Other Other Other Other Other Other Other Other Other Other Other Other Other Other Other Other Other
Sabhi Trading Karke Bahot Accha Faida Utha Sakte Hai ...	Other Other Other Other Other Other Other Other Other Other
Lagta hai #Bitcoin se bhi jyada @iamsrk sir ne speed pakdi hai .. Congrt	Other Other Other Other Other Other Other Other Other Other Other Other Other Other
Aajkal Bitcoin ka craze to dekho ..	Other Other Other Other Other Other Other
Chor hai ye sbi wale or common man ka paisa maar k apni pockets bhar rahe hai 0	Other Other Other B-Org Other Other Other Other Other Other Other Other Other Other Other Other Other Other
Fake fake and fake mera order aaj 1.5 month baad bhi delivered nhi huaa ,,, delivered to dur ki baat hai ship bhi nhi huaa abhi tak #fraud	Other Other Other Other Other Other Other Other Other Other Other Other Other Other Other Other Other Other Other Other Other Other Other Other Other Other Other Other
Till today we believed that hamare #chokidar ji Janta ke peso pe kisi punje Ko girne nahi dege but vo punja to khud #chokidar ka hi nikla 0	Other Other Other Other Other Other Other Other Other Other Other Other Other Other Other Other Other Other Other Other Other Other Other Other Other Other Other Other
This is nothing to do with politics , kisi ne kaha tha , jhooth bolne wala aur jhooth sunne wala dono ko agar pata hai ye jhooth hai , toh ise jhooth nahi kehte ... toh lo aap bhi sun lo #PNBScam nahi , ye #CongressPNBscam Hai shhhhhhh , dheere #ChaukidarSoRahaHai	Other Other Other Other Other Other Other Other Other Other Other Other Other Other Other Other Other Other Other Other Other Other Other Other Other Other Other Other Other Other Other Other Other Other Other Other Other Other Other Other Other Other Other Other Other Other Other Other Other Other Other
@narendramodi dekh raha hoon aajkal aap bhi #ManmohanSingh mode pe chale gaye hain 0	B-Per Other Other Other Other Other Other B-Per Other Other Other Other Other Other
Vyapan pe na state na he centre kuch bol raha hai ... #PMModi #BJP #ArunJaitley #AmitShah #OfficeOfRg #ManmohanSingh #scam #SambitPatra #AhmedPatel #TOI #Congress #INC #NDA #shivsena #shivrajsinghchouhan #AAP #ArvindKejriwal #cmmp	Other Other Other Other Other Other Other Other Other Other Other Other B-Per B-Org B-Per B-Per B-Org B-Per Other B-Per B-Per B-Org B-Org B-Org B-Org B-Org B-Per B-Org B-Per Other
Mahi maar raha hain ... Mahi maar raha hain ... oops !! sorry ... Manmohan Singh bol raha hain : O Maun Baba bol raha hain <3 #ManmohanSingh	Other Other Other Other Other Other Other Other Other Other Other Other Other Other B-Per I-Per Other Other Other Other Other Other Other Other Other Other Other B-Per
#PNBScam Nirav Modi ji bhi scam karke bhaag gaye 0 BJP ke raaj mein hi saare loag kyun bhaag rahe hain ?	Other B-Per I-Per I-Per Other Other Other Other Other Other B-Org Other Other Other Other Other Other Other Other Other Other Other
#nakhaunganakhanedunga #PNBScam #NiravModi @narendramodi @BJP 4 India jawab do desh ko desh janna chahta hai ye scam kyun hua hai @OfficeOfRG @yadavakhilesh @yadavtejashwi @laluprasadrjd	Other Other B-Per B-Per B-Org Other B-Loc Other Other B-Org Other B-Org Other Other Other Other Other Other Other Other Other Other Other Other
