juda hoke bhi tu mujhme kahin baaki hai music release date	HI HI HI HI HI HI HI HI EN EN EN
IIT jee ke results	EN EN HI EN
banarasi silk sarees	HI EN EN
main hoon rahi mastana lyrics	HI HI HI HI EN
jindagi maut naa ban jaaye sambhaalo yaaro lyrics meaning	HI HI HI HI HI HI HI EN EN
maar daala allah maar daala allah maar daala music release	HI HI HI HI HI HI HI HI EN EN
anushka ki cute muskaaan	HI HI EN HI
Commonwealth countries ki list	EN EN HI EN
akhiyon ko moond moond lyrics	HI HI HI HI EN
G20 meeting mein terrorism par charcha	EN EN HI EN HI HI
pyaar se pyaare tum ho sanam video download	HI HI HI HI HI HI EN EN
beetein lamhein video download	HI HI EN EN
china mein swine flu updates	EN HI EN EN EN
vo rulakar hans na paya der tak download	HI HI HI HI HI HI HI EN
tip tip tip tip baarish shuru ho gayi music director	HI HI HI HI HI HI HI HI EN EN
ye ladki kyu na jaane kyu song release	HI HI HI HI HI HI EN EN
kuchh rit jagat ki aisi hai har ek subah ki sham hui listen online	HI HI HI HI HI HI HI HI HI HI HI HI EN EN
is zameen se falak tak listen online	HI HI HI HI HI EN EN
pyar naseeba naal milda huzoor hai lyrics	HI HI HI HI HI HI EN
USA ki economy	EN HI EN
Geeta kitab pujya maani jati hai	HI HI HI HI HI HI
apne deewane ka kar de bura haal movie name	HI HI HI HI HI HI HI EN EN
e mere dil suno koi kahani music release	HI HI HI HI HI HI EN EN
bharat se jyada bhrashtachaar kaha hai	HI HI HI HI HI HI
christians ke tyohar	EN HI HI
chand chhupa baadal mein composer	HI HI HI HI EN
ik din bahaaron ne phoolon se ye kaha dvd version	HI HI HI HI HI HI HI HI EN EN
dil aisa kisine mera toda video	HI HI HI HI HI EN
chanda mama se pyara mera mama music release	HI HI HI HI HI HI EN EN
kuch mere dil ne kaha listen online	HI HI HI HI HI EN EN
hum pyar karne wale song release	HI HI HI HI EN EN
kuch khas hai kuch pas hai kuch ajnabi ehsas hai song lyrics	HI HI HI HI HI HI HI HI HI HI EN EN
ruk jaa o dil deewane song release date	HI HI HI HI HI EN EN EN
dil ka haal sune dil waala youtube	HI HI HI HI HI HI EN
khoya khoya chand khula asman download	HI HI HI HI HI EN
suno gaur se duniya walo sabse aage honge hindustani movie	HI HI HI HI HI HI HI HI HI EN
yoga ke faayde	EN HI HI
faisala tumko bhool jaane ka listen online	HI HI HI HI HI EN EN
tujhse milna milkar chalna achchha lagta hai download	HI HI HI HI HI HI HI EN
kaise mujhe tu mil gayi lyrics	HI HI HI HI HI EN
tu hi haqeeqat khwaab tu movie	HI HI HI HI HI EN
duniya ke journalism schools	HI HI EN EN
resham jaisi hai raahien youtube	HI HI HI HI EN
kashmir mudde par india pakistan talk	HI HI HI EN EN EN
ae ganpat chal daroo la music release	HI HI HI HI HI EN EN
rang bhi dekha roop bhi dekha song lyrics	HI HI HI HI HI HI EN EN
zara tasveer se tu video download	HI HI HI HI EN EN
jilmil sitaro ne kaha video	HI HI HI HI EN
paris mein 2 din 3 raat ka tour package	EN HI EN HI EN HI HI EN EN
dosti imtehaan hai doston ki jaan video download	HI HI HI HI HI HI EN EN
zindagi ke haseen pal quotes	HI HI HI HI EN
Formula One mein Indian Khiladi Narain karthikeyan	EN EN HI EN HI EN EN
bollywood ke super duper gaane	EN HI EN EN HI
irfan ka lajawab hattrick royals win latest	HI HI HI EN EN EN EN
tamil nadu ki famous chutney	EN EN HI EN HI
tujhse bichhadkar ke bhi o be khabar youtube	HI HI HI HI HI HI HI EN
world trade centre ka location	EN EN EN HI EN
tu waaqif nahin singer	HI HI HI EN
sare ke sare music release	HI HI HI EN EN
nifty aur sensex me giravat	EN HI EN HI HI
aaj rapat jayen to hame na uthaiyo song release	HI HI HI HI HI HI HI EN EN
sheila ki jawaani lyrics	HI HI HI EN
raat ka nasha movie name	HI HI HI EN EN
roop tera mastana pyar mera deewana bhool koi hamse na ho jaaye music director	HI HI HI HI HI HI HI HI HI HI HI HI EN EN
aane waal pal wo ja raha hai lyrics meaning	HI HI HI HI HI HI HI EN EN
present bharat ka dharm cricket	EN HI HI HI EN
india ki pehli world cup win	EN HI HI EN EN EN
tera mera pyaar music release date	HI HI HI EN EN EN
ate jathe song lyrics	HI HI EN EN
haseena gori gori lyrics meaning	HI HI HI EN EN
koi mil gaya music release date	HI HI HI EN EN EN
gaayenge hum apne dilon ka taraana listen online	HI HI HI HI HI HI EN EN
coffee with karan ke producer	EN EN HI HI EN
dont worry kar balle shalle music director	HI HI HI HI HI EN EN
ude jab jab julfe teri kunwariyo ka dil machale download	HI HI HI HI HI HI HI HI HI EN
waah tera kya kehna mp3 download	HI HI HI HI EN EN
jab koi baat bigad jae music release date	HI HI HI HI HI EN EN EN
dhak dhak karne laga mora jiya ra darne laga youtube	HI HI HI HI HI HI HI HI HI EN
aa chal ke tujhe main le ke chaloon song composer	HI HI HI HI HI HI HI HI EN EN
is lok ko bhi apna na sake us lok me pachtaoge mp3	HI HI HI HI HI HI HI HI HI HI HI EN
kaisi hai yeh rut ke jis mein	HI HI HI HI HI HI HI
dhyaan ab apna zyaada rakhta hoon sochta hoon main kaisa lagta hoon aaina ho to dekh leta hoon dvd version	HI HI HI HI HI HI HI HI HI HI HI HI HI HI HI HI HI HI EN EN
mumbai mein baarish ka mausam	HI HI HI HI HI
Himachal Pradesh chunav ke results	HI HI HI HI EN
aisa zakhm diya mp3	HI HI HI EN
jhooth nahi hai mera pyar singer	HI HI HI HI HI EN
badlon mein chhup raha hai chaand kyon mp3	HI HI HI HI HI HI HI EN
ruk jana nahi movie	HI HI HI EN
swaasthya ke liye laabhdayak khana	HI HI HI HI HI
jab life ho out of control toh hoto ko karkay gol mp3	HI HI HI HI HI HI HI HI HI HI HI EN
kabhi kabhi mere dil mein khayaal aata hai music director	HI HI HI HI HI HI HI HI EN EN
kitna haseen chehra kitni pyaari aankhein mp3 download	HI HI HI HI HI HI EN EN
sachin ka maha shatak	HI HI HI HI
maria sharapova ex boyfriend vivaad	EN EN EN EN HI
delhi mein taxi suvidha	HI HI EN HI
aasma odh kar dvd version	HI HI HI EN EN
cauvery par karnataka tamil nadu vivaad	EN HI EN EN EN HI
woh tere pyar ka gam lyrics	HI HI HI HI HI EN
NRI marriage serial Bani full episode download	EN EN EN HI EN EN EN
matlab license buy online	EN EN EN EN
tere bare mein jab socha nahi tha composer	HI HI HI HI HI HI HI EN
ja ja ja mujhe na ab yaad aa mujhe na ab yaad aa movie	HI HI HI HI HI HI HI HI HI HI HI HI HI EN
USA ke top ten colleges	EN HI EN EN EN
where are you ke lyrics	EN EN EN HI EN
aam aadmi party karyalay delhi	HI HI EN HI HI
kuchh is tarah teri palken music release date	HI HI HI HI HI EN EN EN
pehli mile hain	HI HI HI
yeh raaste pyaar ke music release date	HI HI HI HI EN EN EN
india ke shiksha pranali ka dimak reservation quota	EN HI HI HI HI HI EN EN
ye hasi wadiyan video	HI HI HI EN
public me dhumrapaan nishedh	EN HI HI HI
jab chali thandi hawa jab uthi kaali ghata download	HI HI HI HI HI HI HI HI EN
ek bata do do bate char video download	HI HI HI HI HI HI EN EN
sapnon ke ghar ki song release date	HI HI HI HI EN EN EN
goa ke chief minister IIT alumnus	HI HI EN EN EN EN
zinda bhaag milkha bhaag mp3 free download	HI HI HI HI EN EN EN
pyaaz ke daam india	HI HI HI EN
keral ka nariyal pani	HI HI HI HI
tumse itna pyaar hai dil mein utar kar dekh lo dvd version	HI HI HI HI HI HI HI HI HI HI EN EN
hame chalte jana hai bas chalte jana mp3	HI HI HI HI HI HI HI EN
microsoft ke cloud solutions	EN HI EN EN
deewna dil deewnadeewana dil deeana youtube	HI HI HI HI HI EN
teri ankhe mujhko take is tarah lyrics meaning	HI HI HI HI HI HI EN EN
piya basanti re kaahe sataaye aaja listen online	HI HI HI HI HI HI EN EN
latest hindi movies ke review	EN HI EN HI EN
bewajah baatein pe ainwe gaur karein dilsa koi kameena nahi video	HI HI HI HI HI HI HI HI HI HI EN
india mein saste mobile phone	EN HI HI EN EN
koi fariyaad video	HI HI EN
pakistani cricket asif spot fixing mudda	HI EN HI EN EN HI
internet ke disadvantages	EN HI EN
chand mera dil dvd version	HI HI HI EN EN
ladkiyo ikraar karo mp3 download	HI HI HI EN EN
MSWord me graph kaise banaye	EN HI EN HI HI
india mein alag alag taxes	EN HI HI HI EN
hum tere mohabbat mein yun paagal rehte hain video	HI HI HI HI HI HI HI HI EN
koi vaada koi iqraar naa kiya singer	HI HI HI HI HI HI EN
jeevan me safar ke music director	HI HI HI HI EN EN
doordarshan rangoli program time	HI HI EN EN
dhalne lagi hai raat koi baat kijiye hai zindagi ka saath koi baat kijiye mp3	HI HI HI HI HI HI HI HI HI HI HI HI HI HI EN
veriya ve kiya kya kasoor maine tera ve lyrics	HI HI HI HI HI HI HI HI EN
kabhi alvida na kehna song composer	HI HI HI HI EN EN
saajan mera us paar hai video download	HI HI HI HI HI EN EN
Barrack Obama ki patni	EN EN HI HI
dil ko tumse pyaar hua pehli baar hua	HI HI HI HI HI HI HI HI
tadap tadap singer	HI HI EN
wafa jinse ki bewafa ho gaye music release date	HI HI HI HI HI HI EN EN EN
alvida mp3	HI EN
aawara pan banjara pan ek khala hai seene me	HI HI HI HI HI HI HI HI HI
rula ke gaya sapna mera baithi hoon kab ho savera music release	HI HI HI HI HI HI HI HI HI HI EN EN
churaya hai teri nazar ne mere dil ka sabro karar lyrics	HI HI HI HI HI HI HI HI HI HI EN
kabhi palkon pe aansu hai song release date	HI HI HI HI HI EN EN EN
hai na bolo download	HI HI HI EN
tum jo ho toh yeh hain yeh hawa youtube	HI HI HI HI HI HI HI HI EN
chod do aanchal mp3	HI HI HI EN
Ramayan aur Mahabharat bahut mahatvapoorn kathaye hai	HI HI HI HI HI HI HI
atif aslam ke gaane	HI HI HI HI
mujh ko pehchan lo main hoon don song release date	HI HI HI HI HI HI HI EN EN EN
lets have some raunak shaunak song composer	EN EN HI HI HI EN EN
sahi jaye na composer	HI HI HI EN
france ka national flower	EN HI EN EN
jab se tujhko hai jaanadil ne kaha na mana song composer	HI HI HI HI HI HI HI HI HI EN EN
ishq kijiye phir samajhiye jindagi kya cheese hai music release	HI HI HI HI HI HI HI HI EN EN
gal dil di das sajna song composer	HI HI HI HI HI EN EN
tera mujhse hai pehle video download	HI HI HI HI EN EN
ek ladki ko dekha lyrics meaning	HI HI HI HI EN EN
phir bhi dil hai hindustani video	HI HI HI HI HI EN
Amar akbar Anthony movie ke director	HI HI EN EN HI EN
hum tum ek kamre mein band ho song composer	HI HI HI HI HI HI HI EN EN
hyderabad ke famous resorts	EN HI EN EN
vikram betaal katha likhe jane ka san	HI HI HI HI HI HI HI
kuch na kaho by mp3	HI HI HI HI EN
kimti kimti hai zindagi youtube	HI HI HI HI EN
jahaan tum ho wahaan main bhi hoon mp3	HI HI HI HI HI HI HI EN
har kisi ka yahan dilkash chehra hai kahan download	HI HI HI HI HI HI HI HI EN
rona kabhin nahin rona music release	HI HI HI HI EN EN
bin tere tere bin sajna sanso me sans aye na video	HI HI HI HI HI HI HI HI HI HI EN
ye dil hi mushkil	HI HI HI HI
rab bhi deewana laage re rab bhi deewana laage re	HI HI HI HI HI HI HI HI HI HI
main jahaan rahu composer	HI HI HI EN
parmeshwar ka vyaapari baba ramdev	HI HI HI HI HI
Rajasthan me ghumne ki jagah	HI HI HI HI HI
dissemination ki paribhasha	EN HI HI
stomach mein dard	EN HI HI
ichak dana beechak dana song release	HI HI HI HI EN EN
kya hua tera waada youtube	HI HI HI HI EN
hanging gardens ki location	EN EN HI EN
shah rukh khan ke fans	HI HI HI HI EN
mere naina sawan bhado song release	HI HI HI HI EN EN
round de chak one song lyrics	HI HI HI HI EN EN
hum tumpe marte hain song release	HI HI HI HI EN EN
toh has de has de has de tu zara song release date	HI HI HI HI HI HI HI HI HI EN EN EN
chehra mera chehra composer	HI HI HI EN
subah ko jab hum neend se jaage aankh khuli unhi se chaar hui music release date	HI HI HI HI HI HI HI HI HI HI HI HI HI EN EN EN
kaise bataaye kyun tujhako chaahe song composer	HI HI HI HI HI EN EN
shahrukh ka dhamakedar performance	HI HI HI EN
kalyug movie cast and songs	HI EN EN EN EN
bhediye ki khaal mein aatank naxalwaadi	HI HI HI HI HI HI
tutak tutak video	HI HI EN
kambakth ishq video	HI HI EN
basmati rice good for health	HI EN EN EN EN
tip tip barsa paani paani ne aag lagayee song release date	HI HI HI HI HI HI HI HI EN EN EN
kumble ki shandar bowling update	HI HI HI EN EN
mere khayalon ke aangan mein koi sapnon ke deep jalaye deep jalaye song release date	HI HI HI HI HI HI HI HI HI HI HI HI EN EN EN
tumhare siwa kuch na chahat karenge mp3	HI HI HI HI HI HI EN
koi nahee tere jaisa song release	HI HI HI HI EN EN
india snowden ko reject kiya	EN EN HI EN HI
london dekha paris dekha song release	HI HI HI HI EN EN
banjar hai sab banjar hai music release date	HI HI HI HI HI EN EN EN
india mein france embassy ki location	EN HI EN EN HI EN
pyaar hua ikraar hua video download	HI HI HI HI EN EN
kaise batayein kyun tujhko chahe video	HI HI HI HI HI EN
pakistan ka independence day	EN HI EN EN
kabir ke dohe english	HI HI HI EN
pv sindhu ko world badminton mein kansya padak	EN EN HI EN EN HI HI HI
ye gila hai aap ki nigaho kaa phul bhi ho darmiya to fansale hue song release	HI HI HI HI HI HI HI HI HI HI HI HI HI HI EN EN
saif kareena ki shaadi	HI HI HI HI
bharatiya submarine mein visfot	HI EN HI HI
jab say dekha tum ko bas dekha tum ko yara music director	HI HI HI HI HI HI HI HI HI HI EN EN
ishq vishq movie review imdb	HI HI EN EN EN
tere bin sanu soneya koi hor naiyo labna mp3	HI HI HI HI HI HI HI HI EN
khao piyo aish karo mitro mp3 download	HI HI HI HI HI EN EN
navbharat times chalo campus	HI EN HI EN
hum jo chalne lage hain youtube	HI HI HI HI HI EN
wahaan kaun hai tera musafir jaayega kahaan singer	HI HI HI HI HI HI HI EN
aai love my india aai love my india youtube	HI HI HI HI HI HI HI HI EN
tu hi haqiqat khwab tu dariya tu hi pyas tu song lyrics	HI HI HI HI HI HI HI HI HI HI EN EN
ridiculous ka matlab bangla	EN HI HI HI
tan man dhan arpit kar	HI HI HI HI HI
kismat se tum humko mile ho movie	HI HI HI HI HI HI EN
kar chale hum fida jaan e tan saathiyo song release date	HI HI HI HI HI HI HI HI EN EN EN
bechain hai meri nazar mp3	HI HI HI HI EN
mujhe tum yaad karna youtube	HI HI HI HI EN
tum bin jiya jaye kaise song composer	HI HI HI HI HI EN EN
Noida ka sabse bada mall	HI HI HI HI EN
haryali aur rasta from purab paschim mp3	HI HI HI EN HI HI EN
tadap tadap lyrics	HI HI EN
delhi gang rape ki sunwai high court	HI EN EN HI HI EN EN
mera jahan dard ka sailaab tere bina movie	HI HI HI HI HI HI HI EN
cheelcheel chillaa ke kajri sunaaye	HI HI HI HI HI
uttarakhand prakritik prakop 2013	HI HI HI EN
excuse me kya re singer	EN EN HI HI EN
shagna da geet hai premi gaun ja raha listen online	HI HI HI HI HI HI HI HI EN EN
africa ka rajnaitik map	EN HI HI EN
nagada nagada composer	HI HI EN
yeh shaam mastani madhosh kiye jaye video	HI HI HI HI HI HI EN
padmasana yoga technique and posture	HI EN EN EN EN
khanabadosh movie	HI EN
chor bazari do naino ki movie name	HI HI HI HI HI EN EN
jai jawaan jai kisan jai vigyan quote	HI HI HI HI HI HI EN
dubai mein gold ka rate	EN HI EN HI EN
in dino dil mera mujhse hai keh raha video download	HI HI HI HI HI HI HI HI EN EN
chand ke pas jo sitar hai video download	HI HI HI HI HI HI EN EN
kashmir to kanyakumari atulya bharat	HI EN EN HI HI
bachcho me badte tanav ka hal	HI HI HI HI HI HI
neela dupatta peela suit song lyrics	HI HI HI HI EN EN
teetar ke do aage teetar movie name	HI HI HI HI HI EN EN
yaad teri aayegi mujhko bada sataayegi music director	HI HI HI HI HI HI EN EN
nana patekar ke mast dialogues	HI HI HI HI EN
zindagi mein koyi kabhi aaye na rabba lyrics	HI HI HI HI HI HI HI EN
mumbai station ke bahar restaurant	HI EN HI HI EN
masterji ki aa gayi chitthi song release date	HI HI HI HI HI EN EN EN
aadhi aadhi jaagi aadhi aadhi soyi aankhein yeh teri to lagta hai royi lekar yeh naam hamara movie	HI HI HI HI HI HI HI HI HI HI HI HI HI HI HI HI HI EN
tera hi karam movie	HI HI HI EN
pal do pal kaa saath hamaaraa pal do pal ke yaaraane hai mp3 download	HI HI HI HI HI HI HI HI HI HI HI HI EN EN
kai baar yoohi dekha hai mp3	HI HI HI HI HI EN
subah se shaam se mera dostana song release	HI HI HI HI HI HI EN EN
maharashtra navnirmaan sena leaders	HI HI HI EN
jaana suno hum download	HI HI HI EN
kyon aajkal neend kam khwab jayda hai song release	HI HI HI HI HI HI HI EN EN
der se laharon me kamal sambhale mere man kaa lyrics meaning	HI HI HI HI HI HI HI HI HI EN EN
jina pyaar se jeena mp3	HI HI HI HI EN
patna ke district adhikari ka bangla	HI HI EN HI HI HI
q zindagi ki raah pe majboor ho gaye singer	HI HI HI HI HI HI HI HI EN
ek bhale maanush ko amaanush banake choda composer	HI HI HI HI HI HI HI EN
agar bewafa tujhko pehchaan jaate to bhoole se bhi ham mohabbat na karte movie name	HI HI HI HI HI HI HI HI HI HI HI HI HI EN EN
jab saamne tum aa jate ho music release date	HI HI HI HI HI HI EN EN EN
emraan hashmi ki sex appeal	HI HI HI EN EN
tod diya dil mera youtube	HI HI HI HI EN
dekho nashe mein music director	HI HI HI EN EN
mitwaa song release	HI EN EN
dheere dheere haule haule lyrics	HI HI HI HI EN
mil gaya lyrics	HI HI EN
kanya hatya paap hai	HI HI HI HI
A R Rahman ke super hit gaane	EN EN EN HI EN EN HI
jiya ho jiya o jiya kuch bol do song lyrics	HI HI HI HI HI HI HI HI EN EN
mere jivan saathi music release date	HI HI HI EN EN EN
world ke sabse devastating bhookamp	EN HI HI EN HI
william shakespeare ke novels	EN EN HI EN
karnataka mein pracheen hanuman mandir ki khoj	EN HI HI HI HI HI HI
mumbai ke chhote business	HI HI HI EN
urdu ke famous lekhak	HI HI EN HI
bhoola tujhe kaise kahaan hua tujhse kab juda ya khuda mp3	HI HI HI HI HI HI HI HI HI HI EN
tanha dil by shaan composer	HI HI HI HI EN
shishu ke liye uchit ahaar	HI HI HI HI HI
santa banta ke funny jokes	HI HI HI EN EN
fiza bhi hain jawaan jawaan hawaa bhi hain rawaan rawaan mp3	HI HI HI HI HI HI HI HI HI HI EN
Jawaharlal Nehru ki biography	HI HI HI EN
toota toota ek parinda aise toota song release	HI HI HI HI HI HI EN EN
jai kali youtube	HI HI EN
jadoo teri nazar music release date	HI HI HI EN EN EN
abhinetri nargis fakri ke top 10 hot pics	HI HI HI HI EN EN EN EN
is jahan ki nahin hain tumhaari aankhein video	HI HI HI HI HI HI HI EN
afghanistan mein taliban ka kabza	EN HI EN HI HI
akshardham mandir ka darshan time	HI HI HI HI EN
haal kya hai dilon ka na puchho sanam singer	HI HI HI HI HI HI HI HI EN
roop suhana lagta hai dvd version	HI HI HI HI EN EN
beedi listen online	HI EN EN
ye duniya ye mehfil youtube	HI HI HI HI EN
mamaji o mamaji song lyrics	HI HI HI EN EN
mere mehbub kayamat hogi dvd version	HI HI HI HI EN EN
atal bihari vajpayee ki kavita	HI HI HI HI HI
nirman vihar delhi metro	HI HI HI EN
chanda mama se pyara mera mama	HI HI HI HI HI HI
hame jo tumhara sahara na milta bhawar me hi bahate kinaaraa naa milta music release date	HI HI HI HI HI HI HI HI HI HI HI HI HI EN EN EN
are yaar jai mai is gaane ko kaise bhool raha tha	HI HI HI HI HI HI HI HI HI HI HI
o sanam lyrics meaning	HI HI EN EN
bane chahe dushman jamana hamara mp3	HI HI HI HI HI EN
tera mera rishta purana dvd version	HI HI HI HI EN EN
thandi hava e chandni soohani youtube	HI HI HI HI HI EN
jalwa tera jalwa lyrics meaning	HI HI HI EN EN
hum hain rahi pyar ke hum se kuch na boliyein youtube	HI HI HI HI HI HI HI HI HI HI EN
khadi te has bol ve na zind saddi rol ve composer	HI HI HI HI HI HI HI HI HI HI EN
yuhi kat jayega music release date	HI HI HI EN EN EN
hari om hari composer	HI HI HI EN
zindagi maut na ban jaye mp3	HI HI HI HI HI EN
e mama han bhangi movie	HI HI HI HI EN
marriage ka naya kanoon delhi high court	EN HI HI HI HI EN EN
musafir hoon yaaro download	HI HI HI EN
time kaise kam waste karein	EN HI HI EN HI
pyar ke side effects movie cast	HI HI EN EN EN EN
gori teri aankhein kahe raat bhar soyi nahi song release	HI HI HI HI HI HI HI HI EN EN
idhar chala mai oodhar chala song release date	HI HI HI HI HI EN EN EN
man ka radio bajne de zara movie name	HI HI HI HI HI HI EN EN
kehna hi kya tera dakhal na koi music release	HI HI HI HI HI HI HI EN EN
columbus columbus music release date	HI HI EN EN EN
mele me ye dil akela video download	HI HI HI HI HI EN EN
teri baahon mein hai jaanam mere jismojaan pighalte mp3	HI HI HI HI HI HI HI HI EN
olympics me bharat ka pradarshan	EN HI HI HI HI
khaak jaisi bevajah si umra saari kahaan chali gayi hai saali khushi video	HI HI HI HI HI HI HI HI HI HI HI HI EN
sachin ganguly ki aakramak partnership	HI HI HI HI EN
khoya khoya chand mp3 download	HI HI HI EN EN
arey ruk jaa rey bandey song composer	HI HI HI HI HI EN EN
USA ke aadhunik hatiyaar	EN HI HI HI
aashiq banaya aapne full song	HI HI HI EN EN
india ne cricket mein top position liya	EN HI EN HI EN EN HI
chanda mama door ke composer	HI HI HI HI EN
tu hi shehar hai mera tujh mein hi ghar hai mera rehta hai tere saath mein download	HI HI HI HI HI HI HI HI HI HI HI HI HI HI HI HI EN
khuda ke liye abi to zara mp3 download	HI HI HI HI HI HI EN EN
zara zara bahekta hai mp3	HI HI HI HI EN
PPC IITKGP ke naye director	EN EN HI HI EN
layi vi na gayee lyrics	HI HI HI HI EN
yeh mere dil ki chain lyrics	HI HI HI HI HI EN
sawre tohe bin jiya music director	HI HI HI HI EN EN
aankhon hi aankhon me ishaara ho gaya movie	HI HI HI HI HI HI HI EN
dhoni ka double dhamaal ICC 2011	HI HI EN HI EN EN
indias most wanted criminals ki list	EN EN EN EN HI EN
jo gumshuda sa khwab tha woh mil gaya woh khil gaya song release date	HI HI HI HI HI HI HI HI HI HI HI EN EN EN
ghar versus hostel mein beeta childhood	HI EN EN HI HI EN
wall dravid ke total shatak	EN EN HI EN HI
soniyo soniyo tumhe dekhta toh sochta hu bas ye hi music release date	HI HI HI HI HI HI HI HI HI HI EN EN EN
roshini se mp3 download	HI HI EN EN
pakistan rajneeti aur brashtachaar	EN HI HI HI
ishq ka kalma lyrics meaning	HI HI HI EN EN
tinka tinka zara zara hai roshni se jaise bhara mp3	HI HI HI HI HI HI HI HI HI EN
naaraz savera hai song release date	HI HI HI EN EN EN
ik din aye ga mp3 download	HI HI HI HI EN EN
namak tere ishq ka video download	HI HI HI HI EN EN
honey singh ka naya album	EN HI HI HI EN
saali khushi movie name	HI HI EN EN
bharat ka sabse bada rajya	HI HI HI HI HI
chak de india song release	HI HI HI EN EN
thode bheege bheege se thode nam hain hum mp3 download	HI HI HI HI HI HI HI HI EN EN
my dil goes hmmm video	EN HI EN EN EN
main agar kahoon song release date	HI HI HI EN EN EN
mooli naal gandha hove movie name	HI HI HI HI EN EN
kore kagaz pe likhwale composer	HI HI HI HI EN
deepika ki back to back bollywood blockbusters	EN HI EN EN EN EN EN
guru stotra meaning in hindi	HI HI EN EN HI
nasha ye pyar ka nasha hai listen online	HI HI HI HI HI HI EN EN
aaj kal zindagi movie name	HI HI HI EN EN
lakdi ki kathi dvd version	HI HI HI EN EN
pagalpan chha gaya dvd version	HI HI HI EN EN
ranchi ka baadshah m.s.dhoni	HI HI HI EN
ek dil se dosti thi woh huzoor bhi kaminey video download	HI HI HI HI HI HI HI HI HI EN EN
ek sau solah chand ki raaten ek tumhare kandhe ka til composer	HI HI HI HI HI HI HI HI HI HI HI EN
kitne gahare halke sham ke rang hai chalke music release	HI HI HI HI HI HI HI HI EN EN
jashn jit ka video	HI HI HI EN
tumse milna bathein karnaa bada achchha lagtha hein music release	HI HI HI HI HI HI HI HI EN EN
Dabanng 2 ke hero	HI EN HI EN
na kajre ki dhaar na motiyon ke haar youtube	HI HI HI HI HI HI HI HI EN
madhoshi hai madhoshi hai tere chahat ki madhoshi hai movie name	HI HI HI HI HI HI HI HI HI EN EN
waada raha pyaar se pyaar ka song composer	HI HI HI HI HI HI EN EN
pyaar ki dastan youtube	HI HI HI EN
tere mere pyar wali gal song release date	HI HI HI HI HI EN EN EN
tanhayee video	HI EN
race saason ki	EN HI HI
aaye ho meri zindagi mein tum bahar banke movie	HI HI HI HI HI HI HI HI EN
muththi mein hai takdeer humari listen online	HI HI HI HI HI EN EN
pyaar diwanaa hota hai afsana hota hai video download	HI HI HI HI HI HI HI EN EN
bharat ki nadi pranali wiki	HI HI HI HI EN
humko to yaara teri yaari download	HI HI HI HI HI EN
kabhi daaldaal kabhi paatpaat main hawa pe dhoondhoo uske nishaan song composer	HI HI HI HI HI HI HI HI HI HI EN EN
saari umra hum dvd version	HI HI HI EN EN
saina nehwal bharatiya brand ambassador	HI HI HI EN EN
dil mera poochh raha hai tujhse singer	HI HI HI HI HI HI EN
mere dil me aaj kya hai video	HI HI HI HI HI HI EN
tumhe kaise main bataon	HI HI HI HI
dil ka soona sa tarana dhundega video	HI HI HI HI HI HI EN
ladki ladki song release	HI HI EN EN
sun zara song release date	HI HI EN EN EN
gori teri by lucky ali composer	HI HI HI HI HI EN
mera dil bhi kitna paagal hai composer	HI HI HI HI HI HI EN
zindagi lyrics	HI EN
snakes ke different species	EN HI EN EN
amitabh bachhan ke dialogues	HI HI HI EN
mere ghar aayi ik nannhi pari movie name	HI HI HI HI HI HI EN EN
zindagi ne zindagi bhar gam diye jitne bhi mausam diye sab nam diye video	HI HI HI HI HI HI HI HI HI HI HI HI HI EN
pankh hote to ud aati re rashiya o jalima song composer	HI HI HI HI HI HI HI HI HI EN EN
aam ke vibhbhin prakar	HI HI HI HI
zara haulle haulle chalo mere saajna	HI HI HI HI HI HI
ooty ki yatra tamil nadu	EN HI HI EN EN
prisoner tihar jail se farar	EN HI EN HI HI
jhuti muti mitwaa awan bole music release date	HI HI HI HI HI EN EN EN
theosophical society ka founder	EN EN HI EN
hanuman chalisa translation in english	HI HI EN EN EN
gale se lagaya hai composer	HI HI HI HI EN
dakshin ka mahadev rajnikanth	HI HI HI EN
sab kariyaat hai video	HI HI HI EN
main koi aisa geet gau movie	HI HI HI HI HI EN
chalte chalte composer	HI HI EN
bharat ke pramukh rajyon me boli aur script	HI HI HI HI HI HI HI EN
haan pahli baar haan pahli baar movie	HI HI HI HI HI HI EN
girta hua woh aasma se music release date	HI HI HI HI HI EN EN EN
chaand sitaare song release date	HI HI EN EN EN
life mein khush rehne ke tareeke	EN HI HI HI HI HI
o bekraar dil ho chuka hai mujhko aansuon se pyaar mp3	HI HI HI HI HI HI HI HI HI HI EN
pineapple raita recipe online	EN HI EN EN
nadal clay court ka maharaj	EN EN EN HI HI
teri yaad aati hai song release	HI HI HI HI EN EN
chhuke yu chali hawa jaise chu gaye ho tum composer	HI HI HI HI HI HI HI HI HI EN
gulposh kabhi itraye kahin mahake to nazar aa jaye kahin lyrics	HI HI HI HI HI HI HI HI HI HI EN
aawaaz iit kgp online ank	HI EN EN EN HI
tu bin bataye mujhe le chal kahi	HI HI HI HI HI HI HI
zindagi ke safar mein singer	HI HI HI HI EN
tirchito pivale singer	HI HI EN
dainik jaagran delhi head office	HI HI HI EN EN
maharashtra pradesh mein sookha	HI HI HI HI
mujhe nind naa aaye youtube	HI HI HI HI EN
tum kya jano	HI HI HI
delhi6	HI
unko ye shikayat hai ki ham kuch nahi kehte	HI HI HI HI HI HI HI HI HI
frienship day ke liye haseen tohfa	EN EN HI HI HI HI
praachin khandaharon mein basti bhaarat ki aatma	HI HI HI HI HI HI HI
kyunki itna pyar tumko karte hain hum	HI HI HI HI HI HI HI
ek haseena thi	HI HI HI
zindhagi 1 safar hai suhaana lyrics meaning	HI HI HI HI HI EN EN
switzerland ki rajdhani	EN HI HI
na jaane kahaan se aai hai	HI HI HI HI HI HI
khushiyan aur gham sehti hai lyrics	HI HI HI HI HI EN
mere to giridhar Gopal dusro na koi	HI HI HI HI HI HI HI
bhor bhaye panghat par song composer	HI HI HI HI EN EN
rounde hai music release	HI HI EN EN
mehbooba mehbooba mp3	HI HI EN
sunayi deti hai kiski dhadkan humara dil ya tumhara dil hai movie name	HI HI HI HI HI HI HI HI HI HI HI EN EN
tum bin jaaoon kahaan movie	HI HI HI HI EN
barna de video	HI HI EN
tere bin kahin lagta hi nai dil composer	HI HI HI HI HI HI HI EN
pyaar ki daastan movie name	HI HI HI EN EN
koi nahi isa composer	HI HI HI EN
mere sapno ki rani kab aayegi tu song lyrics	HI HI HI HI HI HI HI EN EN
ek batta do do batta char song composer	HI HI HI HI HI HI EN EN
samajhte the magar fir bhi na rakhi dooriyan song release	HI HI HI HI HI HI HI HI EN EN
bahoon main chalay aa ho hamsay sanam kya parda dvd version	HI HI HI HI HI HI HI HI HI EN EN
waada tera waada waade pe tere maara gya song release date	HI HI HI HI HI HI HI HI EN EN EN
bharatiya hockey team ko mili svarna olympics	HI EN EN HI HI HI EN
bharat mein sone ka bhav	HI HI HI HI HI
Ashes ka famous shatak	EN HI EN HI
chlormint dobara mat puchna ad salman khan	EN HI HI HI EN HI HI
Harry Potter kitab kaha milegi	EN EN HI HI HI
jab dil hi toot gaya hum jeeke kya karenge movie name	HI HI HI HI HI HI HI HI HI EN EN
india mein disaster management ki prakriya	EN HI EN EN HI HI
kabhi tum nahi the kabhi hum nahi the lyrics meaning	HI HI HI HI HI HI HI HI EN EN
kaha se chale kahake ke liye ye khabar nahi thi magar singer	HI HI HI HI HI HI HI HI HI HI HI EN
tose nainaa laage youtube	HI HI HI EN
congress party ka chunav aayog	EN EN HI HI HI
soniyo movie	HI EN
ladakh mein ghoomne ki jagah	HI HI HI HI HI
badi mushkil hai khoya mera dil hai listen online	HI HI HI HI HI HI HI EN EN
world bank ke headquarters	EN EN HI EN
wake up sid download	HI HI HI EN
kahin machal ke pyaar se chhalke chuye koi mujhe par nazar na aaye listen online	HI HI HI HI HI HI HI HI HI HI HI HI HI EN EN
shah rukh khan ki jivani	HI HI HI HI HI
missing sunday song composer	EN HI EN EN
na tum bolo song lyrics	HI HI HI EN EN
thodi si jo peeli hai mp3 download	HI HI HI HI HI EN EN
singareni coal durghatna	HI EN HI
rupee ki value giri	EN HI EN HI
free hindi vigyapan download	EN HI HI EN
duniya ke largest forests	HI HI EN EN
bangalore ke technical log	EN HI EN EN
